"Complexes_Proteins"	"Genes"	"Object_ID"
"<i>N<sup>5</sup></i>-carboxyaminoimidazole ribonucleotide mutase"	"purE"	"PURE-CPLX"
"NADPH:quinone oxidoreductase MdaB"	"mdaB"	"CPLX0-253"
"UDP-<i>N</i>-acetyl-D-mannosamine dehydrogenase"	"wecC"	"CPLX0-8013"
"tagatose-1,6-bisphosphate aldolase 2"	"gatY" // "gatZ"	"CPLX0-241"
"murein tripeptide amidase A"	"mpaA"	"CPLX0-7989"
"pyridoxal kinase I / hydroxymethylpyrimidine kinase"	"pdxK"	"PDXK-CPLX"
"The Tol-Pal Cell Envelope Complex"	"pal" // "tolA" // "tolB" // "tolR" // "tolQ"	"CPLX0-2201"
"outer membrane channel TolC"	"tolC"	"CPLX0-7964"
"pantothenate synthetase"	"panC"	"PANTOATE-BETA-ALANINE-LIG-CPLX"
"predicted xanthine dehydrogenase"	"xdhD" // "ygfM"	"CPLX0-1841"
"outer membrane phospholipase A"	"pldA"	"CPLX0-7944"
"nitrate reductase Z"	"narY" // "narZ" // "narV"	"NITRATREDUCTZ-CPLX"
"HflK-HflC complex; regulator of FtsH protease"	"hflK" // "hflC"	"CPLX0-1321"
"disulfide reductase / organic hydroperoxide reductase"	"yghU"	"CPLX0-7917"
"methionine&mdash;tRNA ligase"	"metG"	"METG-CPLX"
"5-dehydro-4-deoxy-<small>D</small>-glucuronate isomerase"	"kduI"	"CPLX-8401"
"oxalyl-CoA decarboxylase"	"oxc"	"CPLX0-7878"
"L-1,2-propanediol oxidoreductase"	"fucO"	"LACTALDREDUCT-CPLX"
"mannose-specific PTS enzyme II"	"manZ" // "manY" // "manX"	"CPLX-165"
"putative ethanolamine catabolic microcompartment shell protein EutM"	"eutM"	"CPLX0-7835"
"histidinol-phosphate aminotransferase"	"hisC"	"HISTPHOSTRANS-CPLX"
"chemotaxis protein CheZ"	"cheZ"	"CHEZ-CPLX"
"aldehyde dehydrogenase, Fe-S subunit" // "aldehyde dehydrogenase, FAD-binding subunit" // "aldehyde dehydrogenase: molybdenum cofactor-binding subunit"	"paoA" // "paoB" // "paoC"	"CPLX0-7805"
"glyoxylate carboligase"	"gcl"	"GLYOCARBOLIG-CPLX"
"ATP synthase F<sub>1</sub> complex subunit &beta;"	"atpD"	"ATPD-CPLX"
"HipB antitoxin / DNA-binding transcriptional repressor"	"hipB"	"CPLX0-7757"
"glucose-1-phosphatase"	"agp"	"GLUCOSE-1-PHOSPHAT-CPLX"
"asparagine synthetase A"	"asnA"	"ASNSYNA-CPLX"
"23S rRNA m<sup>5</sup>C1962 methyltransferase"	"rlmI"	"CPLX0-7726"
"fumarase A"	"fumA"	"FUMARASE-A"
"L-asparaginase 1"	"ansA"	"ANSA-CPLX"
"NikR-Ni DNA-binding transcriptional repressor"	"nikR"	"CPLX0-7707"
"3-hydroxy-acyl-[acyl-carrier-protein] dehydratase"	"fabZ"	"FABZ-CPLX"
"adenylosuccinate synthetase"	"purA"	"ADENYLOSUCCINATE-SYN-DIMER"
"sulfoquinovose isomerase"	"yihS"	"CPLX0-7683"
"dihydrolipoyltranssuccinylase"	"sucB"	"E2O"
"&beta; complex" // "&alpha; complex"	"atoA" // "atoD"	"ACETOACETYL-COA-TRANSFER-CPLX"
"maltose outer membrane channel / phage lambda receptor protein"	"lamB"	"CPLX0-7655"
"diaminopimelate decarboxylase"	"lysA"	"DIAMINOPIMDECARB-CPLX"
"divisome protein complex FtsEX"	"ftsE" // "ftsX"	"ABC-54-CPLX"
"Na<sup>+</sup>:H<sup>+</sup> antiporter NhaA"	"nhaA"	"CPLX0-7629"
"cysteine synthase complex"	"cysE" // "cysK"	"CYSSYNMULTI-CPLX"
"leucine / L-phenylalanine ABC transporter"	"livK" // "livM" // "livH" // "livG" // "livF"	"ABC-304-CPLX"
"5-carboxymethylaminomethyluridine-tRNA synthase GTPase subunit"	"mnmE"	"CPLX0-7608"
"DcuS-DctA sensor complex"	"dctA" // "dcuS"	"CPLX0-8306"
"branched chain amino acid / phenylalanine ABC transporter"	"livF" // "livG" // "livH" // "livM" // "livJ"	"ABC-15-CPLX"
"quinate/shikimate dehydrogenase"	"ydiB"	"CPLX0-7462"
"1-phosphofructokinase"	"fruK"	"1-PFK"
"2-<i>C</i>-methyl-D-erythritol 2,4-cyclodiphosphate synthase"	"ispF"	"CPLX0-721"
"amino acid racemase YgeA"	"ygeA"	"CPLX0-8251"
"riboflavin synthase"	"ribC"	"CPLX0-3952"
"HigB translation-dependent mRNA interferase and toxin of the HigB-HigA toxin-antitoxin system"	"higB"	"CPLX0-8228"
"D-arabinose 5-phosphate isomerase GutQ"	"gutQ"	"CPLX0-3929"
"alanine racemase 1"	"alr"	"CPLX0-8202"
"soluble pyridine nucleotide transhydrogenase"	"sthA"	"UDHA-CPLX"
"N<sup>6</sup>-L-threonylcarbamoyladenine synthase"	"tsaE" // "tsaD" // "tsaB"	"CPLX0-8182"
"menaquinol:trimethylamine <i>N</i>-oxide oxidoreductase I"	"torC" // "torA"	"TMAOREDUCTI-CPLX"
"7-cyano-7-deazaguanine reductase"	"queF"	"CPLX0-3501"
"osmotically inducible peroxiredoxin OsmC"	"osmC"	"CPLX0-8157"
"succinylornithine transaminase"	"astC"	"SUCCORNTRANSAM-CPLX"
"ClpAXP"	"clpP" // "clpA" // "clpX"	"CPLX0-3108"
"DNA helicase II"	"uvrD"	"CPLX0-8111"
"allose-6-phosphate isomerase / ribose-5-phosphate isomerase B"	"rpiB"	"RIB5PISOMB-CPLX"
"aspartate 1-decarboxylase"	"panD"	"CPLX0-2901"
"protein translocation ATPase"	"secA"	"CPLX0-8089"
"2-methylcitrate synthase"	"prpC"	"CPLX0-251"
"carboxy-<i>S</i>-adenosyl-L-methionine synthase"	"cmoA"	"CPLX0-8010"
"degradosome"	"ppk" // "rne" // "rhlB" // "pnp" // "eno"	"CPLX0-2381"
"HypCD complex involved in hydrogenase maturation"	"hypD" // "hypC"	"CPLX0-7986"
"transcriptional activator RhaS"	"rhaS"	"PC00086"
"multidrug efflux pump EmrAB-TolC"	"tolC" // "emrA" // "emrB"	"CPLX0-2121"
"chloride:H<sup>+</sup> antiporter ClcA"	"clcA"	"CPLX0-7961"
"orotate phosphoribosyltransferase"	"pyrE"	"OROPRIBTRANS-CPLX"
"copper/silver export system"	"cusC" // "cusB" // "cusF" // "cusA"	"CPLX0-1721"
"regulator of KefC-mediated potassium transport and quinone oxidoreductase"	"kefF"	"CPLX0-7939"
"sensory histidine kinase NarQ"	"narQ"	"NARQ-CPLX"
"MazE-MazF antitoxin/toxin complex / DNA-binding transcriptional repressor"	"mazF" // "mazE"	"CPLX0-1242"
"tellurite methyltransferase"	"tehB"	"CPLX0-7913"
"maltose <i>O</i>-acetyltransferase"	"maa"	"MALTACETYLTRAN-CPLX"
"periplasmic phosphoanhydride phosphatase/multiple inositol-polyphosphate phosphatase"	"appA"	"CPLX-722"
"DNA-binding transcriptional repressor TreR"	"treR"	"CPLX0-7854"
"sensory histidine kinase KdpD"	"kdpD"	"KDPD-CPLX"
"fructose-specific PTS enzyme II"	"fruB" // "fruA"	"CPLX-158"
"iron-sulfur cluster insertion protein SufA"	"sufA"	"CPLX0-7824"
"putative 3-phenylpropionate/cinnamate dioxygenase"	"hcaC" // "hcaD" // "hcaF" // "hcaE"	"HCAMULTI-CPLX"
"carbamoyl phosphate synthetase subunit &beta;" // "carbamoyl phosphate synthetase subunit &alpha;"	"carB" // "carA"	"CARBPSYN-CPLX"
"DNA-binding transcriptional dual regulator FNR"	"fnr"	"CPLX0-7797"
"glycerol kinase"	"glpK"	"GLYCEROL-KIN-CPLX"
"&alpha; complex"	"atoD"	"ATOD-CPLX"
"UhpA-Phosphorylated DNA-binding transcriptional activator"	"uhpA"	"CPLX0-7754"
"glucose-1-phosphate adenylyltransferase"	"glgC"	"GLUC1PADENYLTRANS-CPLX"
"3-deoxy-7-phosphoheptulonate synthase, Phe-sensitive"	"aroG"	"AROG-CPLX"
"2-keto-3-deoxy-L-rhamnonate aldolase"	"yfaU"	"CPLX0-7723"
"formyltetrahydrofolate deformylase"	"purU"	"FORMYLTHFDEFORMYL-CPLX"
"copper-containing amine oxidase"	"tynA"	"AMINEOXID-CPLX"
"MukF dimer"	"mukF"	"CPLX0-7698"
"fructose-1,6-bisphosphatase 1"	"fbp"	"F16B-CPLX"
"long-chain-fatty-acid&mdash;CoA ligase"	"fadD"	"ACYLCOASYN-CPLX"
"ZntR-Zn<sup>2+</sup> DNA-binding transcriptional activator"	"zntR"	"CPLX0-7678"
"1-deoxy-D-xylulose 5-phosphate reductoisomerase"	"dxr"	"DXPREDISOM-CPLX"
"sulfate/thiosulfate ABC transporter"	"sbp" // "cysW" // "cysU" // "cysA"	"ABC-70-CPLX"
"L-rhamnose isomerase"	"rhaA"	"CPLX0-7652"
"dGTP triphosphohydrolase"	"dgt"	"DGTPTRIPHYDRO-CPLX"
"vitamin B<sub>12</sub> ABC transporter"	"btuD" // "btuC" // "btuF"	"ABC-5-CPLX"
"small conductance mechanosensitive channel MscS"	"mscS"	"CPLX0-7626"
"sensor histidine kinase CreC"	"creC"	"CREC-CPLX"
"ribose ABC transporter"	"rbsA" // "rbsC" // "rbsB"	"ABC-28-CPLX"
"ChpB-ChpS complex"	"chpB" // "chpS"	"CPLX0-7561"
"sensor histidine kinase BarA"	"barA"	"CPLX0-8302"
"L-glutamine ABC transporter"	"glnQ" // "glnP" // "glnH"	"ABC-12-CPLX"
"flagellar export apparatus"	"flhA" // "flhB" // "fliO" // "fliP" // "fliQ" // "fliR" // "fliH" // "fliI" // "fliJ"	"CPLX0-7451"
"putative tRNA-binding protein YgjH"	"ygjH"	"CPLX0-8269"
"putative hydrolase"	"ycaC"	"CPLX0-661"
"uracil:H<sup>+</sup> symporter UraA"	"uraA"	"CPLX0-8247"
"thiazole synthase"	"thiG" // "thiH"	"CPLX0-3949"
"thiosulfate sulfurtransferase YgaP"	"ygaP"	"CPLX0-8219"
"FKBP-type peptidyl-prolyl <i>cis-trans</i> isomerase FklB"	"fklB"	"CPLX0-3924"
"oxygen-sensing c-di-GMP phosphodiesterase DosP"	"dosP"	"CPLX0-8199"
"tryptophanase"	"tnaA"	"TRYPTOPHAN-CPLX"
"&beta; sliding clamp"	"dnaN"	"CPLX0-3761"
"putative phosphatidylethanolamine synthesis regulator GnsA"	"gnsA"	"CPLX0-8177"
"threonine dehydrogenase"	"tdh"	"THREODEHYD-CPLX"
"fused 4'-phosphopantothenoylcysteine decarboxylase and phosphopantothenoylcysteine synthetase"	"dfp"	"CPLX0-341"
"c-di-GMP-binding biofilm dispersal mediator protein"	"bdcA"	"CPLX0-8154"
"spermidine synthase"	"speE"	"SPERMIDINESYN-CPLX"
"ClpX ATP-dependent protease specificity component and chaperone"	"clpX"	"CPLX0-3102"
"small heat shock protein IbpA"	"ibpA"	"CPLX0-8108"
"RecFOR complex"	"recF" // "recR" // "recO"	"RECFOR-CPLX"
"curved DNA-binding protein"	"cbpA"	"CPLX0-2802"
"molybdopterin molybdotransferase"	"moeA"	"CPLX0-8045"
"guanosine-5'-triphosphate,3'-diphosphate phosphatase"	"gpp"	"PPPGPPHYDRO-CPLX"
"cysteine desulfurase"	"iscS"	"CPLX0-248"
"UDP-<i>N</i>-acetylglucosamine 2-epimerase"	"wecB"	"CPLX0-8008"
"DNA polymerase III, core enzyme"	"dnaE" // "dnaQ" // "holE"	"CPLX0-2361"
"moderate conductance mechanosensitive channel YbiO"	"ybiO"	"CPLX0-7983"
"acrylyl-CoA reductase"	"yhdH"	"CPLX0-8121"
"DNA-binding transcriptional dual regulator CysB"	"cysB"	"PC00040"
"phosphoribosylaminoimidazole-succinocarboxamide synthase"	"purC"	"SAICARSYN-CPLX"
"DNA-binding transcriptional dual regulator HU"	"hupA" // "hupB"	"CPLX0-2021"
"isoaspartyl dipeptidase"	"iadA"	"CPLX0-3021"
"methylphosphonate degradation complex"	"phnL" // "phnH" // "phnG" // "phnI"	"CPLX0-7958"
"methyl-accepting chemotaxis protein Tar"	"tar"	"CPLX0-8102"
"ornithine carbamoyltransferase"	"argI"	"ORNCARBAMTRANSFERI-CPLX"
"pyrroline-5-carboxylate reductase"	"proC"	"PYRROLINECARBREDUCT-CPLX"
"ribonuclease E inhibitor protein A"	"rraA"	"CPLX0-1642"
"bacterial condensin MukBEF"	"mukB" // "mukF" // "mukE"	"CPLX0-2561"
"carbon-phosphorus lyase core complex"	"phnJ" // "phnI" // "phnH" // "phnG"	"CPLX0-7935"
"pyridoxal kinase 2"	"pdxY"	"CPLX0-8031"
"fused N-acetylglucosamine-1-phosphate uridyltransferase and glucosamine-1-phosphate acetyltransferase"	"glmU"	"NAG1P-URIDYLTRANS-CPLX"
"nitrogen regulator GlnK"	"glnK"	"PII2-CPLX"
"HslVU protease"	"hslU" // "hslV"	"CPLX0-1163"
"DNA gyrase"	"gyrA" // "gyrB"	"CPLX0-2425"
"RnlA-RnlB toxin-antitoxin complex"	"rnlB" // "rnlA"	"CPLX0-7909"
"poly-<i>N</i>-acetyl-D-glucosamine synthase"	"pgaD" // "pgaC"	"CPLX0-7994"
"maltodextrin phosphorylase"	"malP"	"MALDEXPHOSPHORYL-CPLX"
"phenylacetaldehyde dehydrogenase"	"feaB"	"PHENDEHYD-CPLX"
"exodeoxyribonuclease VII"	"xseA" // "xseB"	"CPLX-3946"
"anaerobic ribonucleoside-triphosphate reductase activating protein"	"nrdG"	"CPLX0-229"
"2,3-dihydroxybenzoyl-EntB"	"entB"	"CPLX0-7849"
"DNA-binding transcriptional repressor/NMN adenylyltransferase NadR"	"nadR"	"CPLX0-7975"
"isocitrate lyase"	"aceA"	"ISOCIT-LYASE"
"DNA-binding transcriptional dual regulator CRP"	"crp"	"PC00004"
"<I>N,N'</I>-diacetylchitobiose-specific PTS enzyme II"	"chbA" // "chbC" // "chbB"	"CPLX-155"
"vitamin B12 outer membrane transport complex"	"btuB" // "exbD" // "exbB" // "tonB"	"CPLX0-1924"
"3-hydroxy-2,4-pentadione 5-phosphate thiolase"	"lsrF"	"CPLX0-7820"
"2-hydroxy-6-oxononatrienedioate hydrolase"	"mhpC"	"CPLX0-7950"
"GTP cyclohydrolase 2"	"ribA"	"GTP-CYCLOHYDRO-II-CPLX"
"ribonucleoside-diphosphate reductase 2, &alpha; subunit dimer"	"nrdE"	"NRDE-CPLX"
"biotin synthase"	"bioB"	"BIOTIN-SYN-CPLX"
"serine protease inhibitor ecotin"	"eco"	"CPLX0-1441"
"3-sulfolactaldehyde reductase"	"yihU"	"CPLX0-7794"
"NADPH-dependent curcumin/dihydrocurcumin reductase"	"curA"	"CPLX0-7927"
"glutamate-5-semialdehyde dehydrogenase"	"proA"	"GLUTSEMIALDEHYDROG-CPLX"
"MtlR-HPr"	"mtlR" // "ptsH"	"MONOMER0-2461"
"aspartate kinase III"	"lysC"	"ASPKINIII-CPLX"
"tRNA-guanine transglycosylase"	"tgt"	"CPLX0-1101"
"DNA-binding transcriptional dual regulator MurR"	"murR"	"CPLX0-7745"
"glutamate&mdash;pyruvate aminotransferase AlaC"	"alaC"	"CPLX0-7887"
"glutamate dehydrogenase"	"gdhA"	"GDHA-CPLX"
"6,7-dimethyl-8-ribityllumazine synthase"	"ribE"	"LUMAZINESYN-CPLX"
"chorismate synthase"	"aroC"	"AROC-CPLX"
"sorbitol-specific PTS enzyme II"	"srlA" // "srlB" // "srlE"	"CPLX-169"
"undecaprenyl-phosphate-&alpha;-L-Ara4N flippase - ArnE subunit" // "undecaprenyl-phosphate-&alpha;-L-Ara4N flippase - ArnF subunit"	"arnE" // "arnF"	"CPLX0-7720"
"sulfur acceptor protein CsdE"	"csdE"	"CPLX0-7839"
"formate dehydrogenase O"	"fdoG" // "fdoH" // "fdoI"	"FORMATEDEHYDROGO-CPLX"
"homoserine <i>O</i>-succinyltransferase"	"metA"	"HOMSUCTRAN-CPLX"
"alkaline phosphatase"	"phoA"	"ALKAPHOSPHA-CPLX"
"citrate lyase, citryl-acyl carrrier protein lyase component"	"citE"	"CITRYLY-CPLX"
"glutaminase 2"	"glsB"	"CPLX0-7695"
"heme-containing peroxidase/deferrochelatase"	"efeB"	"CPLX0-7810"
"ethanolamine ammonia-lyase subunit &alpha;" // "ethanolamine ammonia-lyase subunit &beta;"	"eutB" // "eutC"	"ETHAMLY-CPLX"
"GMP reductase"	"guaC"	"GMP-REDUCT-CPLX"
"citrate lyase [acyl carrier protein] component"	"citD"	"ACPSUB-CPLX"
"ribonucleoside-diphosphate reductase 1, &alpha; subunit dimer"	"nrdA"	"B1-CPLX"
"MntR-Mn<sup>2+</sup> DNA-binding transcriptional dual regulator"	"mntR"	"CPLX0-7672"
"proofreading thioesterase in enterobactin biosynthesis"	"entH"	"CPLX0-7766"
"protein sulfenic acid reductase and chaperone DsbG"	"dsbG"	"DSBG-CPLX"
"glutamine synthetase"	"glnA"	"GLUTAMINESYN-OLIGOMER"
"Zn<sup>2+</sup> ABC transporter ATP binding subunit" // "Zn<sup>2+</sup> ABC transporter membrane subunit" // "Zn<sup>2+</sup> ABC transporter periplasmic binding protein"	"znuC" // "znuB" // "znuA"	"ABC-63-CPLX"
"aspartate ammonia-lyase"	"aspA"	"ASPARTASE-CPLX"
"ribokinase"	"rbsK"	"CPLX0-7647"
"<i>N</i>-acetylmuramic acid 6-phosphate etherase"	"murQ"	"CPLX0-7732"
"thymidine phosphorylase"	"deoA"	"DEOA-CPLX"
"4-aminobutyrate aminotransferase GabT"	"gabT"	"GABATRANSAM-CPLX"
"galactofuranose ABC transporter"	"yjfF" // "ytfR" // "ytfT" // "ytfQ"	"ABC-46-CPLX"
"RNA polymerase, core enzyme"	"rpoA" // "rpoC" // "rpoB"	"APORNAP-CPLX"
"regulator of acid resistance, influenced by indole"	"ariR"	"CPLX0-7623"
"periplasmic chaperone Skp"	"skp"	"CPLX0-7711"
"periplasmic chaperone, inhibitor of vertebrate C-type lysozyme"	"ivy"	"CPLX0-921"
"formate dehydrogenase H" // "hydrogenase 3"	"fdhF" // "hycE" // "hycB" // "hycG" // "hycF" // "hycC" // "hycD"	"FHLMULTI-CPLX"
"putrescine ABC transporter"	"potG" // "potH" // "potI" // "potF"	"ABC-25-CPLX"
"aerobic glycerol 3-phosphate dehydrogenase"	"glpD"	"AERGLYC3PDEHYDROG-CPLX"
"arginine:agmatine antiporter"	"adiC"	"CPLX0-7535"
"succinate semialdehyde dehydrogenase (NAD(P)<sup>+</sup>) Sad"	"sad"	"CPLX0-7687"
"ribose-phosphate diphosphokinase"	"prs"	"CPLX0-8299"
"enolase"	"eno"	"ENOLASE-CPLX"
"8-amino-7-oxononanoate synthase"	"bioF"	"7KAPSYN-CPLX"
"acetyl-CoA acetyltransferase"	"atoB"	"ACETYL-COA-ACETYLTRANSFER-CPLX"
"1-deoxy-D-xylulose-5-phosphate synthase"	"dxs"	"CPLX0-743"
"D-sedoheptulose 7-phosphate isomerase"	"gmhA"	"CPLX0-7660"
"GDP-mannose hydrolase"	"nudK"	"CPLX0-3971"
"NAD(P)H nitroreductase NfsB"	"nfsB"	"DIHYDROPTERIREDUCT-CPLX"
"redox-responsive ATPase YchF"	"ychF"	"CPLX0-8240"
"Autoinducer-2 ABC transporter periplasmic binding protein" // "Autoinducer-2 ABC transporter membrane subunit LsrD" // "Autoinducer-2 ABC transporter membrane subunit LsrC" // "Autoinducer-2 ABC transporter ATP binding subunit"	"lsrB" // "lsrD" // "lsrC" // "lsrA"	"ABC-58-CPLX"
"phenylacetyl-CoA thioesterase"	"paaI"	"CPLX0-3941"
"L-fuculose-phosphate aldolase"	"fucA"	"CPLX0-7633"
"carboxylesterase"	"yjfP"	"CPLX0-8214"
"cytidine/deoxycytidine deaminase"	"cdd"	"CYTIDEAM-CPLX"
"multidrug/spermidine efflux pump"	"mdtJ" // "mdtI"	"YDGEF-CPLX"
"heme trafficking system CcmABCDE"	"ccmD" // "ccmB" // "ccmA" // "ccmE" // "ccmC"	"ABC-35-CPLX"
"heat shock protein, hemimethylated DNA-binding protein"	"hspQ"	"CPLX0-3921"
"putative ethanolamine catabolic microcompartment shell protein EutN"	"eutN"	"CPLX0-7613"
"nucleotide exchange factor GrpE"	"grpE"	"CPLX0-8192"
"DNA-binding transcriptional  repressor CRP-Sxy"	"sxy" // "crp"	"CPLX0-8312"
"transketolase 1"	"tktA"	"TRANSKETOI-CPLX"
"arabinose ABC transporter"	"araG" // "araH" // "araF"	"ABC-2-CPLX"
"ADP-L-glycero-D-mannoheptose 6-epimerase"	"rfaD"	"CPLX0-3681"
"2-succinyl-5-enolpyruvyl-6-hydroxy-3-cyclohexene-1-carboxylate synthase"	"menD"	"CPLX0-7525"
"Cas1-Cas2 complex"	"cas2" // "cas1"	"CPLX0-8174"
"DUF945 domain-containing protein YdgA"	"ydgA"	"CPLX0-8281"
"thioredoxin reductase"	"trxB"	"THIOREDOXIN-REDUCT-NADPH-CPLX"
"3-methyl-2-oxobutanoate hydroxymethyltransferase"	"panB"	"3-METHYL-2-OXOBUT-OHCH3XFER-CPLX"
"NADH:quinone oxidoreductase I, peripheral arm"	"nuoB" // "nuoC" // "nuoE" // "nuoF" // "nuoG" // "nuoI"	"CPLX0-3361"
"tRNA Cm32/Um32 methyltransferase"	"trmJ"	"CPLX0-7420"
"1,4-dihydroxy-2-naphthoyl-CoA hydrolase"	"menI"	"CPLX0-8128"
"HU&alpha;&alpha;"	"hupA"	"CPLX0-8256"
"siroheme synthase"	"cysG"	"SIROHEMESYN-CPLX"
"ATP dependent structure specific DNA nuclease"	"sbcC" // "sbcD"	"CPLX0-3957"
"Sec translocon accessory complex"	"yidC" // "yajC" // "secF" // "secD"	"SECD-SECF-YAJC-YIDC-CPLX"
"carnitine monooxygenase"	"yeaX" // "yeaW"	"CPLX0-8232"
"aminopeptidase A/I and DNA-binding transcriptional repressor"	"pepA"	"CPLX0-3061"
"Outer Membrane Protein Assembly Complex"	"bamE" // "bamC" // "bamD" // "bamA" // "bamB"	"CPLX0-3933"
"methyl-accepting chemotaxis protein Trg - ribose/galactose/glucose-sensing"	"trg"	"CPLX0-8105"
"periplasmic acid stress chaperone HdeB"	"hdeB"	"CPLX0-8207"
"putative quinone oxidoreductase 1"	"qorA"	"QOR-CPLX"
"<i>ditrans,polycis</i>-undecaprenyl-diphosphate synthase [(2<i>E</i>,6<i>E</i>)-farnesyl-diphosphate specific]"	"uppS"	"UPPSYN-CPLX"
"chaperone protein HtpG"	"htpG"	"CPLX0-2641"
"DNA polymerase III, holoenzyme"	"holE" // "dnaQ" // "dnaE" // "holA" // "holB" // "dnaX" // "dnaN" // "holD" // "holC"	"CPLX0-3803"
"dTDP-glucose pyrophosphorylase"	"rfbA"	"CPLX0-8034"
"galactitol-1-phosphate 5-dehydrogenase"	"gatD"	"CPLX0-8186"
"pyruvate kinase II"	"pykA"	"PKII-CPLX"
"multidrug efflux pump AcrAB-TolC"	"tolC" // "acrA" // "acrB"	"TRANS-CPLX-201"
"transcription termination factor Rho"	"rho"	"CPLX0-2441"
"D-aminoacyl-tRNA deacylase"	"dtd"	"CPLX0-3581"
"phosphate acetyltransferase"	"pta"	"PHOSACETYLTRANS-CPLX"
"molybdopterin adenylyltransferase"	"mog"	"CPLX0-8163"
"2-<i>C</i>-methyl-D-erythritol 4-phosphate cytidylyltransferase"	"ispD"	"CPLX0-234"
"inosine/guanosine kinase"	"gsk"	"CPLX0-322"
"monoacetylchitobiose-6-phosphate hydrolase"	"chbF"	"CPLX0-7979"
"tetrahydrodipicolinate succinylase"	"dapD"	"CPLX0-3181"
"DNA-binding transcriptional repressor LexA"	"lexA"	"PC00010"
"L-ribulose-5-phosphate 4-epimerase AraD"	"araD"	"RIBULPEPIM-CPLX"
"ferric citrate outer membrane transport complex"	"fecA" // "exbD" // "exbB" // "tonB"	"CPLX0-1943"
"primosomal replication protein N"	"priB"	"CPLX0-3"
"acetate/glycolate:cation symporter"	"actP"	"CPLX0-7955"
"ribonuclease E inhibitor protein B"	"rraB"	"CPLX0-8096"
"nucleoside diphosphate kinase"	"ndk"	"NUCLEOSIDE-DIP-KIN-CPLX"
"5-(carboxyamino)imidazole ribonucleotide synthase"	"purK"	"PURK-CPLX"
"5'-methylthioadenosine/<i>S</i>-adenosylhomocysteine nucleosidase"	"mtn"	"CPLX0-1541"
"methylmalonyl-CoA decarboxylase"	"scpB"	"CPLX0-254"
"cytosine/isoguanine deaminase"	"codA"	"CPLX0-7932"
"UDP-<i>N</i>-acetylmuramate&mdash;L-alanine ligase"	"murC"	"CPLX0-8014"
"N-acetylglutamate synthase"	"argA"	"N-ACETYLTRANSFER-CPLX"
"thiosulfate sulfurtransferase GlpE"	"glpE"	"CPLX0-242"
"formyl-CoA transferase"	"frc"	"CPLX0-1142"
"dTDP-4-dehydro-6-deoxy-D-glucose transaminase"	"wecE"	"CPLX0-7990"
"pyrimidine-specific ribonucleoside hydrolase RihB"	"rihB"	"CPLX0-7904"
"phosphoenolpyruvate carboxylase"	"ppc"	"PEPCARBOX-CPLX"
"lysine&mdash;tRNA ligase/Ap<sub>4</sub>A synthetase/Ap<sub>3</sub>A synthetase"	"lysU"	"LYSU-CPLX"
"NADPH-dependent FMN reductase"	"ssuE"	"CPLX0-224"
"sulfurtransferase complex TusBCD"	"tusB" // "tusC" // "tusD"	"CPLX-3942"
"HypT-[Met]reduced"	"hypT"	"CPLX0-7970"
"<i>p</i>-aminobenzoyl-glutamate hydrolase"	"abgB" // "abgA"	"CPLX0-7844"
"pantothenate kinase"	"coaA"	"PANTOTHENATE-KIN-CPLX"
"catalase HPII"	"katE"	"HYDROPEROXIDII-CPLX"
"radiation resistance protein YbgI"	"ybgI"	"CPLX0-1863"
"cobinamide-P guanylyltransferase / cobinamide kinase"	"cobU"	"COBU-CPLX"
"zinc-binding phosphatase YcdX"	"ycdX"	"CPLX0-7945"
"glutaredoxin 4"	"grxD"	"CPLX0-7817"
"nitrite reductase subunit NirD" // "nitrite reductase catalytic subunit NirB"	"nirD" // "nirB"	"NITRITREDUCT-CPLX"
"glutamate-1-semialdehyde aminotransferase"	"hemL"	"GSAAMINOTRANS-CPLX"
"SufBC<sub>2</sub>D Fe-S cluster scaffold complex"	"sufB" // "sufC" // "sufD"	"CPLX0-1341"
"biotin carboxyl carrier protein (dimer)"	"accB"	"BCCP-CPLX"
"mannose-specific PTS enzyme IIAB component"	"manX"	"CPLX0-7921"
"NAD-dependent dihydropyrimidine dehydrogenase"	"preT" // "preA"	"CPLX0-7788"
"methylglyoxal synthase"	"mgsA"	"METHGLYSYN-CPLX"
"glutamate decarboxylase A"	"gadA"	"GLUTDECARBOXA-CPLX"
"NusB-S10 complex"	"rpsJ" // "nusB"	"CPLX0-7879"
"aspartate carbamoyltransferase catalytic subunit" // "aspartate carbamoyltransferase, regulatory subunit"	"pyrB" // "pyrI"	"ASPCARBTRANS-CPLX"
"lysine decarboxylase 2"	"ldcC"	"LDC2-CPLX"
"DNA-binding transcriptional repressor CytR"	"cytR"	"CPLX0-7740"
"mannitol-specific PTS enzyme II"	"mtlA"	"CPLX-166"
"glyceraldehyde-3-phosphate dehydrogenase A"	"gapA"	"GAPDH-A-CPLX"
"putative ethanolamine catabolic microcompartment shell protein EutS"	"eutS"	"CPLX0-7836"
"peptidoglycan glycosyltransferase / peptidoglycan DD-transpeptidase MrcA"	"mrcA"	"CPLX0-7717"
"bifunctional hydroxymethylpyrimidine kinase/phosphomethylpyrimidine kinase"	"thiD"	"HMP-P-KIN-CPLX"
"GTP cyclohydrolase 1"	"folE"	"FOLE-CPLX"
"fused chorismate mutase/prephenate dehydratase"	"pheA"	"CHORISMUTPREPHENDEHYDRAT-CPLX"
"2-amino-3-ketobutyrate CoA ligase"	"kbl"	"AKBLIG-CPLX"
"disulfide reductase"	"yfcG"	"CPLX0-7806"
"nucleoside triphosphate pyrophosphohydrolase"	"mazG"	"CPLX0-7692"
"serine hydroxymethyltransferase"	"glyA"	"GLYOHMETRANS-CPLX"
"<i>holo</i>-EntB dimer" // "phosphopantetheinyl transferase EntD" // "<i>holo</i> [EntF peptidyl-carrier protein]" // "2,3-dihydroxybenzoate-[aryl-carrier protein] ligase"	"entB" // "entD" // "entF" // "entE"	"ENTMULTI-CPLX"
"ATP synthase F<sub>0</sub> complex - subunit c"	"atpE"	"ATPE-CPLX"
"acetylornithine deacetylase"	"argE"	"ACETYLORNDEACET-CPLX"
"2'-<i>O</i>-acetyl-ADP-ribose deacetylase, regulator of RNase III activity"	"ymdB"	"CPLX0-7758"
"NADPH-dependent aldehyde reductase YqhD"	"yqhD"	"CPLX0-7667"
"glutamate synthase"	"gltB" // "gltD"	"GLUTAMATESYN-CPLX"
"3,4-dihydroxy-2-butanone-4-phosphate synthase"	"ribB"	"DIOHBUTANONEPSYN-CPLX"
"asparagine synthetase B"	"asnB"	"ASNSYNB-CPLX"
"putative transport complex, ABC superfamily"	"yphD" // "yphF" // "yphE"	"ABC-60-CPLX"
"16S rRNA m<sup>3</sup>U1498 methyltransferase"	"rsmE"	"CPLX0-7727"
"ketol-acid reductoisomerase (NADP<sup>+</sup>)"	"ilvC"	"CPLX0-7643"
"fumarase B"	"fumB"	"FUMARASE-B"
"adenosylmethionine-8-amino-7-oxononanoate aminotransferase"	"bioA"	"DAPASYN-CPLX"
"L-asparaginase 2"	"ansB"	"ANSB-CPLX"
"putative oligopeptide ABC transporter ATP binding subunit YejF" // "putative oligopeptide ABC transporter membrane subunit YejB" // "putative oligopeptide ABC transporter membrane subunit YejE" // "putative oligopeptide ABC transporter periplasmic binding protein YejA"	"yejF" // "yejB" // "yejE" // "yejA"	"ABC-41-CPLX"
"DNA-binding transcriptional dual regulator CueR-Cu<sup>+</sup>"	"cueR"	"CPLX0-7708"
"tartronate semialdehyde reductase 2"	"glxR"	"CPLX0-7616"
"fatty acid oxidation complex, &beta; component"	"fadA"	"FADA-CPLX"
"ClpA ATP-dependent protease specificity component and chaperone"	"clpA"	"CPLX0-881"
"adenylyl-sulfate kinase"	"cysC"	"ADENYLYLSULFKIN-CPLX"
"oligopeptide ABC transporter"	"oppC" // "oppD" // "oppF" // "oppB" // "oppA"	"ABC-22-CPLX"
"L-valine exporter"	"ygaZ" // "ygaH"	"CPLX0-7684"
"ammonia / ammonium transporter"	"amtB"	"CPLX0-7532"
"lipoamide dehydrogenase"	"lpd"	"E3-CPLX"
"aminopeptidase YpdF"	"ypdF"	"CPLX0-8290"
"acetohydroxy acid synthase I subunit IlvB" // "acetohydroxy acid synthase I subunit IlvN"	"ilvB" // "ilvN"	"ACETOLACTSYNI-CPLX"
"6-phosphofructokinase 2"	"pfkB"	"6PFK-2-CPX"
"4-hydroxy-tetrahydrodipicolinate synthase"	"dapA"	"DIHYDRODIPICSYN-CPLX"
"23S rRNA m<sup>3</sup>&Psi;1915 methyltransferase"	"rlmH"	"CPLX0-7423"
"putative transport complex, ABC superfamily"	"ycjP" // "ycjO" // "ycjN" // "ycjV"	"ABC-55-CPLX"
"thymidine/deoxyuridine kinase"	"tdk"	"CPLX0-8261"
"multifunctional acyl-CoA thioesterase I and protease I and lysophospholipase L1"	"tesA"	"CPLX0-7630"
"hydroxyisourate hydrolase / transthyretin-related protein"	"hiuH"	"CPLX0-3961"
"cystathionine &beta;-lyase / L-cysteine desulfhydrase / alanine racemase"	"metC"	"CYSTATHIONINE-BETA-LYASE-CPLX"
"DLP12 prophage; crossover junction endodeoxyribonuclease RusA"	"rusA"	"CPLX0-8237"
"thiamin ABC transporter ATP binding subunit" // "thiamin ABC transporter membrane subunit" // "thiamin ABC transporter periplasmic binding protein"	"thiQ" // "thiP" // "thiB"	"ABC-32-CPLX"
"evolved &beta;-D-galactosidase"	"ebgA" // "ebgC"	"CPLX0-3937"
"5-carboxymethylaminomethyluridine-tRNA synthase GTPase subunit" // "5-carboxymethylaminomethyluridine-tRNA synthase subunit MnmG"	"mnmE" // "mnmG"	"CPLX0-7609"
"hydroxyethylthiazole kinase"	"thiM"	"CPLX0-8211"
"maltose ABC transporter"	"malK" // "malF" // "malG" // "malE"	"ABC-16-CPLX"
"excision nuclease UvrABC"	"uvrB" // "uvrC" // "uvrA"	"UVRABC-CPLX"
"alanine racemase 2"	"dadX"	"CPLX0-7465"
"fructoselysine 3-epimerase"	"frlC"	"CPLX0-3861"
"sensory histidine kinase GlrK"	"glrK"	"CPLX0-8275"
"peptidyl-lysine <i>N</i>-acetyltransferase"	"patZ"	"CPLX0-8189"
"2-oxoglutarate dehydrogenase complex"	"sucA" // "sucB" // "lpd"	"2OXOGLUTARATEDEH-CPLX"
"multidrug efflux pump MdtEF-TolC"	"tolC" // "mdtE" // "mdtF"	"TRANS-CPLX-204"
"lipid A disaccharide synthase"	"lpxB"	"CPLX0-7415"
"replicative DNA helicase"	"dnaB"	"CPLX0-3621"
"D-alanyl-D-alanine carboxypeptidase DacA"	"dacA"	"CPLX0-8252"
"hydrogenase 1, oxygen tolerant hydrogenase"	"hyaC" // "hyaB" // "hyaA"	"CPLX0-8167"
"<i>S</i>-formylglutathione hydrolase / <i>S</i>-lactoylglutathione hydrolase"	"yeiG"	"CPLX0-3954"
"superoxide dismutase (Mn)"	"sodA"	"SUPEROX-DISMUTMN-CPLX"
"HigA antitoxin of the HigB-HigA toxin-antitoxin system and DNA-binding transcriptional repressor"	"higA"	"CPLX0-8229"
"RNase III"	"rnc"	"CPLX0-3281"
"FlhDC DNA-binding transcriptional dual regulator"	"flhD" // "flhC"	"CPLX0-3930"
"tRNA cytosine<sup>32</sup> 2-sulfurtransferase TtcA"	"ttcA"	"CPLX0-8124"
"signaling pathway modulator ZraP"	"zraP"	"CPLX0-8204"
"UDP-glucose 4-epimerase"	"galE"	"UDPGLUCEPIM-CPLX"
"serine endoprotease"	"degS"	"CPLX0-8183"
"sensory histidine kinase TorS"	"torS"	"TORS-CPLX"
"polynucleotide phosphorylase"	"pnp"	"CPLX0-3521"
"D-lactate dehydrogenase"	"ldhA"	"CPLX0-8158"
"sulfate adenylyltransferase"	"cysD" // "cysN"	"SULFATE-ADENYLYLTRANS-CPLX"
"chromate reductase"	"yieF"	"CPLX0-3121"
"ribosomal protein-arginine oxygenase"	"roxA"	"CPLX0-8112"
"ribonucleoside-diphosphate reductase 1"	"nrdA" // "nrdB"	"RIBONUCLEOSIDE-DIP-REDUCTI-CPLX"
"periplasmic serine endoprotease DegP"	"degP"	"CPLX0-2921"
"diguanylate cyclase DgcM"	"dgcM"	"CPLX0-8090"
"amidophosphoribosyltransferase"	"purF"	"PRPPAMIDOTRANS-CPLX"
"&beta;-ketoacyl-[acyl carrier protein] synthase III"	"fabH"	"CPLX0-252"
"UDP-<i>N</i>-acetylglucosamine&mdash;undecaprenyl-phosphate <i>N</i>-acetylglucosaminephosphotransferase"	"rfe"	"CPLX0-8011"
"tagatose-1,6-bisphosphate aldolase 1"	"kbaY" // "kbaZ"	"CPLX0-240"
"predicted enamine/imine deaminase"	"tdcF"	"CPLX0-7987"
"DNA-binding transcriptional repressor MngR"	"mngR"	"PC00103"
"multidrug efflux pump AcrEF-TolC"	"tolC" // "acrE" // "acrF"	"CPLX0-2141"
"L-amino acid N-acyltransferase"	"mnaT"	"CPLX0-7962"
"orotidine-5'-phosphate decarboxylase"	"pyrF"	"OROTPDECARB-CPLX"
"phenylacetyl-CoA 1,2-epoxidase"	"paaE" // "paaA" // "paaC" // "paaB"	"CPLX0-1762"
"CP4-6 prophage; putative 2-dehydro-3-deoxygluconate aldolase"	"yagE"	"CPLX0-7940"
"sensory histidine kinase NarX"	"narX"	"NARX-CPLX"
"transketolase 2"	"tktB"	"CPLX0-1261"
"multifunctional nuclease Cas1"	"cas1"	"CPLX0-7914"
"<i>o</i>-succinylbenzoate&mdash;CoA ligase"	"menE"	"MENE-CPLX"
"allantoate amidohydrolase"	"allC"	"CPLX-7524"
"sensor histidine kinase AtoS"	"atoS"	"CPLX0-7870"
"KHG/KDPG aldolase"	"eda"	"KDPGALDOL-4OH2OXOGLUTARALDOL-CPLX"
"putative PTS enzyme II FrvAB"	"frvB" // "frvA"	"CPLX-159"
"dITP/XTP pyrophosphatase"	"rdgB"	"CPLX0-7826"
"histidine&mdash;tRNA ligase"	"hisS"	"HISS-CPLX"
"&gamma;-butyrobetainyl-CoA:carnitine CoA transferase"	"caiB"	"CARNDEHYDRA-CPLX"
"predicted structural protein, ethanolamine utilization microcompartment"	"eutL"	"CPLX0-7801"
"glycogen phosphorylase"	"glgP"	"GLYCOPHOSPHORYL-CPLX"
"ATP synthase F<sub>1</sub> complex subunit &alpha;"	"atpA"	"ATPA-CPLX"
"purine nucleoside phosphoramidase"	"hinT"	"CPLX0-7755"
"D-gluconate kinase, thermostable"	"gntK"	"GLUCONOKINII-CPLX"
"3-deoxy-7-phosphoheptulonate synthase, Trp-sensitive"	"aroH"	"AROH-CPLX"
"formate dehydrogenase formation protein"	"fdhE"	"CPLX0-7724"
"fructose-bisphosphate aldolase class I"	"fbaB"	"FRUCBISALD-CLASSI"
"AMP nucleosidase"	"amn"	"AMP-NUCLEOSID-CPLX"
"ATP-dependent Lipid A-core flippase"	"msbA"	"CPLX0-7704"
"&beta;-hydroxyacyl-acyl carrier protein dehydratase/isomerase"	"fabA"	"FABA-CPLX"
"aminodeoxychorismate lyase"	"pabC"	"ADCLY-CPLX"
"DNA-binding transcriptional repressor Zur"	"zur"	"CPLX0-7679"
"2-oxoglutarate decarboxylase, thiamine-requiring"	"sucA"	"E1O"
"dipeptide ABC transporter"	"dppD" // "dppF" // "dppB" // "dppC" // "dppA"	"ABC-8-CPLX"
"water channel AqpZ"	"aqpZ"	"CPLX0-7653"
"3-carboxyethylcatechol 2,3-dioxygenase"	"mhpB"	"DHPDIOXYGEN-CPLX"
"putative transport complex, ABC superfamily"	"ydcS" // "ydcT" // "ydcV" // "ydcU"	"ABC-51-CPLX"
"large conductance mechanosensitive channel"	"mscL"	"CPLX0-7627"
"CTP synthetase"	"pyrG"	"CTPSYN-CPLX"
"putrescine ABC exporter"	"sapF" // "sapC" // "sapB" // "sapD"	"ABC-29-CPLX"
"1-hydroxy-2-methyl-2-(E)-butenyl 4-diphosphate reductase"	"ispH"	"CPLX0-7564"
"putative aminoacrylate hydrolase RutD"	"rutD"	"CPLX0-8303"
"glutamate / aspartate ABC transporter"	"gltI" // "gltK" // "gltJ" // "gltL"	"ABC-13-CPLX"
"flagellum"	"fliL" // "fliE" // "fliF" // "flgI" // "flgG" // "flgF" // "flgC" // "flgB" // "motB" // "motA" // "flgH" // "fliG" // "fliM" // "fliN" // "fliJ" // "fliI" // "fliH" // "fliR" // "fliQ" // "fliP" // "fliO" // "flhB" // "flhA" // "flgE" // "flgK" // "flgL" // "fliC" // "fliD"	"CPLX0-7452"
"sensor histidine kinase CpxA"	"cpxA"	"CPLX0-8270"
"NAD kinase"	"nadK"	"CPLX0-682"
"phosphodiesterase YfcE"	"yfcE"	"CPLX0-8248"
"tRNA m<sup>1</sup>G37 methyltransferase"	"trmD"	"CPLX0-3950"
"transcription antiterminator and regulator of RNA stability"	"cspE"	"CPLX0-8223"
"DNA polymerase V"	"umuC" // "umuD"	"CPLX0-3925"
"cyclic di-GMP phosphodiesterase PdeF"	"pdeF"	"CPLX0-8200"
"tyrosine aminotransferase"	"tyrB"	"TYRB-DIMER"
"YefM-YoeB antitoxin/toxin complex / DNA-binding transcriptional repressor"	"yoeB" // "yefM"	"CPLX0-3781"
"disaggregating chaperone protein ClpB"	"clpB"	"CPLX0-8180"
"threonine&mdash;tRNA ligase"	"thrS"	"THRS-CPLX"
"ribonuclease E"	"rne"	"CPLX0-3461"
"periplasmic protein CpxP"	"cpxP"	"CPLX0-8155"
"succinate:quinone oxidoreductase subcomplex"	"sdhA" // "sdhB" // "sdhC" // "sdhD"	"SUCC-DEHASE"
"ClpAP"	"clpP" // "clpA"	"CPLX0-3104"
"DNA-binding transcriptional activator/c-di-GMP phosphodiesterase PdeL"	"pdeL"	"CPLX0-8109"
"rhamnulose-1-phosphate aldolase"	"rhaD"	"RHAMNULPALDOL-CPLX"
"transcriptional antiterminator BglG"	"bglG"	"CPLX0-2861"
"SecB chaperone"	"secB"	"CPLX0-8046"
"exopolyphosphatase"	"ppx"	"PPX-CPLX"
"hydrogenase 4"	"hyfG" // "hyfI" // "hyfA" // "hyfB" // "hyfC" // "hyfD" // "hyfE" // "hyfF" // "hyfH"	"CPLX0-250"
"type I fimbriae usher protein"	""	"CPLX0-8009"
"serine acetyltransferase"	"cysE"	"CPLX0-237"
"glutathionyl-hydroquinone reductase YqjG"	"yqjG"	"CPLX0-7984"
"DNA-binding transcriptional dual regulator Cra"	"cra"	"PC00061"
"2,3-diketo-L-gulonate reductase"	"yiaK"	"CPLX0-2061"
"adenylosuccinate lyase"	"purB"	"CPLX0-7959"
"ornithine decarboxylase, biosynthetic"	"speC"	"ORNDECARBOX-BIO-CPLX"
"anaerobic fatty acid &beta;-oxidation complex"	"fadI" // "fadJ"	"CPLX0-1668"
"5-phospho-&alpha;-D-ribosyl 1,2-cyclic phosphate phosphodiesterase"	"phnP"	"CPLX0-7936"
"<i>N</i>-acetylglucosamine-6-phosphate deacetylase"	"nagA"	"NAG6PDEACET-CPLX"
"ADP-sugar diphosphatase NudE"	"nudE"	"CPLX0-1221"
"DNA polymerase III, &psi;-&chi; subunit"	"holC" // "holD"	"CPLX0-7910"
"Trg<SUP>glu</SUP>"	"cheA" // "cheW" // "trg"	"TRG-GLU"
"NAD<sup>+</sup>-dependent malate dehydrogenase"	"maeA"	"MALIC-NAD-CPLX"
"acetyl-CoA carboxylase complex"	"accD" // "accA" // "accC" // "accB"	"ACETYL-COA-CARBOXYLMULTI-CPLX"
"allantoinase"	"allB"	"CPLX-64"
"sensory histidine kinase TorS - his850 phosphorylated"	"torS"	"CPLX0-8268"
"GadE-RcsB DNA-binding transcriptional activator"	"rcsB" // "gadE"	"CPLX0-7852"
"sensor histidine kinase ArcB"	"arcB"	"ARCB-CPLX"
"3-deoxy-D-<i>manno</i>-octulosonate 8-phosphate phosphatase KdsC"	"kdsC"	"KDO-8PPHOSPHAT-CPLX"
"isocitrate dehydrogenase"	"icd"	"ISOCITHASE-CPLX"
"mannitol-specific PTS enzyme II CmtBA"	"cmtB" // "cmtA"	"CPLX-156"
"sensory histidine kinase NarX - phosphorylated"	"narX"	"PHOSPHO-NARX"
"MqsA-MqsR antitoxin/toxin complex"	"mqsA" // "mqsR"	"CPLX0-7822"
"guanylate kinase"	"gmk"	"GUANYL-KIN-CPLX"
"chemotaxis signaling complex - serine sensing"	"cheW" // "cheA" // "tsr"	"TSR-CPLX"
"branched-chain-amino-acid aminotransferase"	"ilvE"	"BRANCHED-CHAINAMINOTRANSFER-CPLX"
"BglG - his208 phosphorylated"	"bglG"	"CPLX0-8117"
"KdpE-Phosphorylated DNA-binding transcriptional activator"	"kdpE"	"CPLX0-7795"
"Tar<SUP>glu</SUP>"	"cheA" // "cheW" // "tar"	"TAR-GLU"
"glycerol-3-phosphate dehydrogenase, biosynthetic"	"gpsA"	"GLYC3PDEHYDROGBIOSYN-CPLX"
"aspartate&mdash;tRNA ligase"	"aspS"	"ASPS-CPLX"
"Tap<SUP>glu</SUP>"	"cheA" // "cheW" // "tap"	"TAP-GLU"
"lipid hydroperoxide peroxidase"	"tpx"	"CPLX0-7747"
"pyruvate formate-lyase (inactive)"	"pflB"	"PYRUVFORMLY-INACTIVE-CPLX"
"GDP-mannose 4,6-dehydratase"	"gmd"	"GDPMANDEHYDRA-CPLX"
"DNA-binding transcriptional dual regulator NtrC"	"glnG"	"GLNG-CPLX"
"3-dehydroquinate dehydratase"	"aroD"	"AROD-CPLX"
"protein sulfenic acid reductase DsbG<sub>oxidized</sub>"	"dsbG"	"CPLX0-8004"
"DcuR-Phosphorylated DNA-binding transcriptional activator"	"dcuR"	"CPLX0-7721"
"DNA-binding transcriptional dual regulator TorR"	"torR"	"TORR-CPLX"
"hydrogenase 2"	"hybA" // "hybB" // "hybO" // "hybC"	"FORMHYDROG2-CPLX"
"formate dehydrogenase N, subcomplex"	"fdnI" // "fdnH" // "fdnG"	"ALPHA-SUBUNIT-CPLX"
"chemotaxis signaling complex - dipeptide sensing"	"cheA" // "cheW" // "tap"	"TAP-CPLX"
"chromosome partitioning protein MukB"	"mukB"	"CPLX0-7696"
"ATP synthase F<sub>1</sub> complex"	"atpC" // "atpH" // "atpA" // "atpG" // "atpD"	"F-1-CPLX"
"Trg<SUP>glu-Me</SUP>"	"cheA" // "cheW" // "trg"	"TRG-GLUME"
"cysteine synthase A"	"cysK"	"ACSERLYA-CPLX"
"TorR-TorI"	"torR"	"CPLX0-2821"
"voltage-gated K<sup>+</sup> channel"	"kch"	"CPLX0-7674"
"chemotaxis signaling complex - ribose/galactose/glucose sensing"	"cheA" // "cheW" // "trg"	"TRG-CPLX"
"dTDP-glucose 4,6-dehydratase 1"	"rfbB"	"DTDPGLUCDEHYDRAT-CPLX"
"RNA polymerase sigma 32"	"rpoB" // "rpoC" // "rpoA" // "rpoH"	"RNAP32-CPLX"
"taurine ABC transporter periplasmic binding protein" // "taurine ABC transporter membrane subunit" // "taurine ABC transporter ATP binding subunit"	"tauA" // "tauC" // "tauB"	"ABC-64-CPLX"
"anaerobic ribonucleoside-triphosphate reductase"	"nrdD"	"RIBONUCLEOSIDE-TRIP-REDUCT-CPLX"
"anti-sigma factor stabilizing protein RseB"	"rseB"	"CPLX0-7648"
"chemotaxis protein CheA(L)"	"cheA"	"CHEA-CPLX"
"purine nucleoside phosphorylase"	"deoD"	"DEOD-CPLX"
"Tsr<SUP>glu-Me</SUP>"	"cheW" // "cheA" // "tsr"	"TSR-GLUME"
"putative transport complex, ABC superfamily"	"ynjC" // "ynjD" // "ynjB"	"ABC-48-CPLX"
"RNA polymerase sigma 24"	"rpoB" // "rpoC" // "rpoA" // "rpoE"	"RNAPE-CPLX"
"YhaV-PrlF toxin-antitoxin complex"	"prlF" // "yhaV"	"CPLX0-7624"
"RNA polymerase sigma 19"	"rpoB" // "rpoC" // "rpoA" // "fecI"	"CPLX0-221"
"DNA-binding transcriptional dual regulator PspF"	"pspF"	"CPLX0-981"
"citrate lyase, inactive"	"citD" // "citF" // "citE"	"CITLY-CPLX"
"glycine betaine ABC transporter"	"proV" // "proW" // "proX"	"ABC-26-CPLX"
"RNA polymerase sigma 54"	"rpoB" // "rpoC" // "rpoA" // "rpoN"	"RNAP54-CPLX"
"FKBP-type peptidyl-prolyl <i>cis-trans</I> isomerase SlyD"	"slyD"	"CPLX0-7536"
"KdpE-P<sup>asp</sup>-phosphate"	"kdpE"	"CPLX0-8272"
"PBP1B&gamma;"	"mrcB"	"CPLX0-8300"
"RNA polymerase sigma 70"	"rpoB" // "rpoC" // "rpoA" // "rpoD"	"RNAP70-CPLX"
"ferric enterobactin ABC transporter"	"fepC" // "fepD" // "fepG" // "fepB"	"ABC-10-CPLX"
"RNA polymerase sigma 28"	"fliA" // "rpoB" // "rpoC" // "rpoA"	"CPLX0-222"
"DUF892 domain-containing protein YciF"	"yciF"	"CPLX0-7444"
"OmpR-Phosphorylated DNA-binding transcriptional dual regulator"	"ompR"	"PHOSPHO-OMPR"
"Enterobacterial Common Antigen Biosynthesis Protein Complex"	"wzxE" // "wzyE" // "wzzE"	"CPLX0-3976"
"CreC-<i>N</i>-phospho-L-histidine"	"creC"	"PHOSPHO-CREC"
"intermembrane transport protein PqiB"	"pqiB"	"CPLX0-8244"
"RNA polymerase sigma S"	"rpoB" // "rpoC" // "rpoA" // "rpoS"	"RNAPS-CPLX"
"&gamma;-glutamyl-&gamma;-aminobutyrate hydrolase"	"puuD"	"CPLX0-3943"
"sensory histidine kinase TorS - his443 phosphorylated"	"torS"	"CPLX0-8265"
"free methionine-(<i>R</i>)-sulfoxide reductase"	"msrC"	"CPLX0-8217"
"Tar<SUP>glu-Me</SUP>"	"cheA" // "cheW" // "tar"	"TAR-GLUME"
"primosome"	"dnaB" // "dnaT" // "priB" // "priA" // "priC" // "dnaG"	"CPLX0-3922"
"sensory histidine kinase NtrB - phosphorylated"	"glnL"	"PROTEIN-NRIIP"
"Z-ring positioning protein MinC"	"minC"	"CPLX0-8196"
"tryptophan&mdash;tRNA ligase"	"trpS"	"TRPS-CPLX"
"CpxA-<i>N</i>-phospho-L-histidine"	"cpxA"	"PHOSPHO-CPXA"
"ADP-sugar pyrophosphatase"	"nudF"	"CPLX0-3721"
"reduced flavorubredoxin"	"norV"	"CPLX0-1"
"sulfurtransferase for molybdenum cofactor sulfuration"	"fdhD"	"CPLX0-8175"
"chemotaxis signaling complex - aspartate sensing"	"cheA" // "cheW" // "tar"	"TAR-CPLX"
"catabolic threonine dehydratase"	"tdcB"	"THREDEHYDCAT-CPLX"
"HypT-[Met-oxidized] DNA-binding transcriptional dual regulator"	"hypT"	"CPLX0-8075"
"Type II secretion system"	"gspC" // "gspD" // "gspE" // "gspF" // "gspG" // "gspH" // "gspI" // "gspJ" // "gspK" // "gspL" // "gspM" // "gspO"	"CPLX0-3382"
"citrate lyase"	"citD" // "citF" // "citE"	"ACECITLY-CPLX"
"DLP12 prophage; DNA base-flipping protein"	"ybcN"	"CPLX0-8129"
"Tap<SUP>glu-Me</SUP>"	"cheA" // "cheW" // "tap"	"TAP-GLUME"
"sorbitol-6-phosphate 2-dehydrogenase"	"srlD"	"SORB6PDEHYDROG-CPLX"
"TorR-Phosphorylated DNA-binding transcriptional dual regulator"	"torR"	"PHOSPHO-TORR"
"SecYEG translocon"	"secE" // "secG" // "secY"	"SECE-G-Y-CPLX"
"sensory histidine kinase KdpD - phosphorylated"	"kdpD"	"PHOSPHO-KDPD"
"Xaa-Pro aminopeptidase"	"pepP"	"CPLX0-3081"
"nucleoside triphosphate pyrophosphatase YhdE"	"yhdE"	"CPLX0-8106"
"BglG - his101 phosphorylated"	"bglG"	"CPLX0-7657"
"quinolinate phosphoribosyltransferase (decarboxylating)"	"nadC"	"QUINOPRIBOTRANS-CPLX"
"McrBC restriction endonuclease"	"mcrB" // "mcrC"	"CPLX0-2661"
"DNA-binding transcriptional repressor LsrR"	"lsrR"	"CPLX0-8043"
"porphobilinogen synthase"	"hemB"	"PORPHOBILSYNTH-CPLX"
"<i>holo</i>-EntB dimer"	"entB"	"ENTB-CPLX"
"alkyl hydroperoxide reductase"	"ahpC" // "ahpF"	"CPLX0-245"
"protein sulfenic acid reductase DsbG<sub>reduced</sub>"	"dsbG"	"CPLX-9344"
"3-oxoacyl-[acyl-carrier-protein] reductase FabG"	"fabG"	"CPLX0-8005"
"2,3-bisphosphoglycerate-dependent phosphoglycerate mutase"	"gpmA"	"PHOSGLYCMUTASE"
"glyoxylate reductase"	"ghrB"	"CPLX0-235"
"PhoQ-<i>N</i>-phospho-L-histidine"	"phoQ"	"PHOSPHO-PHOQ"
"miniconductance mechanosensitive channel YbdG"	"ybdG"	"CPLX0-7981"
"DNA-binding transcriptional dual regulator IHF"	"ihfA" // "ihfB"	"PC00027"
"oxidized ribonucleoside-triphosphate reductase"	"nrdD"	"MONOMER0-2863"
"3-hydroxy acid dehydrogenase"	"ydfG"	"CPLX0-1962"
"CheA(L) - phosphorylated"	"cheA"	"CPLX0-8274"
"carbon storage regulator"	"csrA"	"CPLX0-7956"
"<i>O</i>-succinylhomoserine(thiol)-lyase / <i>O</i>-succinylhomoserine lyase"	"metB"	"O-SUCCHOMOSERLYASE-CPLX"
"Tsr<SUP>gln</SUP>"	"cheW" // "cheA" // "tsr"	"TSR-GLN"
"selenate reductase"	"ynfE" // "ynfF" // "ynfG" // "ynfH"	"CPLX0-1601"
"activated pyruvate-formate lyase"	"pflB"	"PYRUVFORMLY-CPLX"
"putative carbamoyltransferase YgeW"	"ygeW"	"CPLX0-7933"
"NAD synthetase, NH<sub>3</sub>-dependent"	"nadE"	"NAD-SYNTH-CPLX"
"HslU hexamer"	"hslU"	"CPLX0-1161"
"L-carnitine:&gamma;-butyrobetaine antiporter"	"caiT"	"CPLX0-7906"
"L-xylulose kinase"	"lyxK"	"LYXK-CPLX"
"FecAR Signal Transduction System"	"fecA" // "fecR"	"CPLX-3944"
"sensory histidine kinase TorS - asp723 phosphorylated"	"torS"	"CPLX0-8267"
"4-hydroxythreonine-4-phosphate dehydrogenase"	"pdxA"	"CPLX0-7847"
"imidazoleglycerol-phosphate dehydratase / histidinol-phosphatase"	"hisB"	"IMIDHISTID-CPLX"
"Trg<SUP>gln</SUP>"	"cheA" // "cheW" // "trg"	"TRG-GLN"
"&beta;-glucoside specific PTS enzyme II"	"ascF"	"CPLX-153"
"NtrC-Phosphorylated DNA-binding transcriptional dual regulator"	"glnG"	"PROTEIN-NRIP"
"K<sup>+</sup> : H<sup>+</sup> antiporter KefC"	"kefC"	"CPLX0-7819"
"sensory histidine kinase NarQ  - phosphorylated"	"narQ"	"PHOSPHO-NARQ"
"fused glutathionylspermidine amidase / glutathionylspermidine synthetase"	"gss"	"GSP-CPLX"
"&beta;-galactosidase"	"lacZ"	"BETAGALACTOSID-CPLX"
"macrodomain Ter protein"	"matP"	"CPLX0-7789"
"glutamate decarboxylase B"	"gadB"	"GLUTDECARBOXB-CPLX"
"&beta;-glucoside specific PTS enzyme II - cys24 phosphorylated"	"bglF"	"CPLX0-8115"
"fused aspartate kinase/homoserine dehydrogenase 1"	"thrA"	"ASPKINIHOMOSERDEHYDROGI-CPLX"
"Tar<SUP>gln</SUP>"	"cheA" // "cheW" // "tar"	"TAR-GLN"
"methylmalonyl-CoA mutase"	"scpA"	"CPLX0-7741"
"glycine cleavage system"	"lpd" // "gcvP" // "gcvH" // "gcvT"	"GCVMULTI-CPLX"
"arginine decarboxylase, biosynthetic"	"speA"	"ARGDECARBOXBIO-CPLX"
"UDP-4-amino-4-deoxy-L-arabinose formyltransferase/UDP-glucuronate dehydrogenase"	"arnA"	"CPLX0-7718"
"dihydroneopterin triphosphate 2'-epimerase"	"folX"	"FOLXTET-CPLX"
"alanine&mdash;tRNA ligase/DNA-binding transcriptional repressor"	"alaS"	"ALAS-CPLX"
"isocitrate dehydrogenase-P"	"icd"	"ISOCITHASE-P"
"FMN dependent NADH:quinone oxidoreductase"	"azoR"	"CPLX0-7693"
"sensor histidine kinase EnvZ"	"envZ"	"ENVZ-CPLX"
"Tap<SUP>gln</SUP>"	"cheA" // "cheW" // "tap"	"TAP-GLN"
"<i>N</i>-acetylornithine aminotransferase / <i>N</i>-succinyldiaminopimelate aminotransferase"	"argD"	"ACETYLORNTRANSAM-CPLX"
"putative oxidoreductase YdjA"	"ydjA"	"CPLX0-7668"
"nicotinate-nucleotide&mdash;dimethylbenzimidazole phosphoribosyltransferase"	"cobT"	"DMBPPRIBOSYLTRANS-CPLX"
"putative transport complex, ABC superfamily"	"ybbP" // "ybbA"	"ABC-61-CPLX"
"L-fucose mutarotase"	"fucU"	"CPLX0-7645"
"oxidized flavorubredoxin"	"norV"	"CPLX0-2"
"dCTP deaminase"	"dcd"	"DCTP-DEAM-CPLX"
"PhoR-<i>N</i>-phospho-L-histidine"	"phoR"	"PHOSPHO-PHOR"
"D-allose ABC transporter ATP binding subunit" // "D-allose ABC transporter membrane subunit" // "D-allose ABC transporter periplasmic binding protein"	"alsA" // "alsC" // "alsB"	"ABC-42-CPLX"
"EnvZ-<i>N</i>-phospho-L-histidine"	"envZ"	"PHOSPHO-ENVZ"
"iron-sulfur cluster insertion protein ErpA"	"erpA"	"CPLX0-7617"
"AtoS-<i>N</i>-phospho-L-histidine"	"atoS"	"PHOSPHO-ATOS"
"tRNA adenosine<sup>34</sup> deaminase"	"tadA"	"CPLX0-901"
"cryptic phosphonate/phosphate ABC transporter"	"phnC" // "phnE" // "phnD"	"ABC-23-CPLX"
"sensor histidine kinase DcuS"	"dcuS"	"CPLX0-8307"
"outer membrane porin C"	"ompC"	"CPLX0-7533"
"heme chaperone HemW"	"hemW"	"CPLX0-8291"
"Tsr<SUP>glu</SUP>"	"cheW" // "cheA" // "tsr"	"TSR-GLU"
"6-phosphogluconate dehydrogenase, decarboxylating"	"gnd"	"6PGLUCONDEHYDROG-CPLX"
"HipAB toxin/antitoxin complex / DNA-binding transcriptional repressor"	"hipB" // "hipA"	"CPLX0-7425"
"nucleotide 5'-monophosphate nucleosidase"	"ppnN"	"CPLX0-8262"
"ferritin iron-storage complex"	"ftnA"	"CPLX0-3969"
"putative menaquinol-cytochrome <i>c</i> reductase NrfCD"	"nrfD" // "nrfC"	"CPLX0-8238"
"copper binding protein CutA"	"cutA"	"CPLX0-3938"
"erythronate-4-phosphate dehydrogenase"	"pdxB"	"CPLX0-8212"
"xanthosine phosphorylase"	"xapA"	"XANTHOSINEPHOSPHORY-CPLX"
"GDP-L-fucose synthase"	"fcl"	"CPLX0-3881"
"tRNA U34 carboxymethyltransferase"	"cmoB"	"CPLX0-8190"
"transaldolase B"	"talB"	"TRANSALDOLB-CPLX"
"&gamma;-aminobutyraldehyde dehydrogenase"	"patD"	"CPLX0-3641"
"bifunctional sensor histidine kinase PhoQ"	"phoQ"	"CPLX0-8168"
"twin arginine protein translocation system"	"tatB" // "tatC" // "tatE" // "tatA"	"TATABCE-CPLX"
"DNA replication inhibitor"	"cspD"	"CPLX0-3301"
"cellulose synthase"	"bcsB" // "bcsA"	"CPLX0-8125"
"&alpha; cleavage product of SpeD" // "&beta; cleavage product of SpeD"	"speD"	"SAMDECARB-CPLX"
"fructose-1,6-bisphosphatase 2"	"glpX"	"CPLX0-303"
"methyl-accepting chemotaxis protein - serine-sensing"	"tsr"	"CPLX0-8103"
"pyruvate dehydrogenase" // "pyruvate dehydrogenase, E2 subunit" // "lipoamide dehydrogenase"	"aceE" // "aceF" // "lpd"	"PYRUVATEDEH-CPLX"
"protein HokC"	"hokC"	"CPLX0-2621"
"acetyl-CoA:oxalate CoA-transferase"	"yfdE"	"CPLX0-8032"
"nitrogen regulatory protein PII-1"	"glnB"	"PIIPROTEIN-CPLX"
"inorganic pyrophosphatase"	"ppa"	"CPLX0-243"
"diaminopimelate epimerase"	"dapF"	"CPLX0-7997"
"phenylalanine&mdash;tRNA ligase"	"pheS" // "pheT"	"PHES-CPLX"
"isocitrate dehydrogenase kinase/phosphatase"	"aceK"	"CPLX0-230"
"translocation and assembly module"	"tamB" // "tamA"	"CPLX0-7976"
"DNA-binding transcriptional dual regulator ArgR"	"argR"	"PC00005"
"ferric enterobactin outer membrane transport complex"	"exbD" // "exbB" // "tonB" // "fepA"	"CPLX0-1941"
"2-hydroxypentadienoate hydratase"	"mhpD"	"CPLX0-7951"
"ribonucleoside-diphosphate reductase 2, &beta; subunit dimer"	"nrdF"	"NRDF-CPLX"
"RNA-binding protein Hfq"	"hfq"	"CPLX0-1461"
"Qin prophage; antitoxin/DNA-binding transcriptional repressor RelB"	"relB"	"CPLX0-7928"
"23S rRNA 2'-<i>O</i>-ribose G2251 methyltransferase"	"rlmB"	"CPLX0-1121"
"glutamate&mdash;pyruvate aminotransferase AlaA"	"alaA"	"CPLX0-7888"
"lysine decarboxylase 1"	"cadA"	"LYSDECARBOX-CPLX"
"galactosamine-specific PTS enzyme II (cryptic)"	"agaB" // "agaC" // "agaD"	"CPLX-170"
"sulfite reductase, flavoprotein subunit complex"	"cysJ"	"CPLX0-7841"
"hydrogenase 3"	"hycD" // "hycC" // "hycF" // "hycG" // "hycB" // "hycE"	"HYDROG3-CPLX"
"citrate lyase, citrate-acyl carrier protein transferase component"	"citF"	"CITTRANS-CPLX"
"protoporphyrinogen oxidase"	"hemG"	"CPLX0-7811"
"GMP synthetase"	"guaA"	"GMP-SYN-CPLX"
"ribonucleoside-diphosphate reductase 1, &beta; subunit dimer"	"nrdB"	"B2-CPLX"
"fructose 1,6-bisphosphatase YggF"	"yggF"	"CPLX0-7776"
"glutathione reductase (NADPH)"	"gor"	"GLUTATHIONE-REDUCT-NADPH-CPLX"
"aspartate carbamoyltransferase catalytic subunit"	"pyrB"	"ASPCARBCAT-TRIMER"
"DNA-binding transcriptional dual regulator AsnC"	"asnC"	"CPLX0-7733"
"galactoside <i>O</i>-acetyltransferase"	"lacA"	"GALACTOACETYLTRAN-CPLX"
"cytochrome <i>bd</i>-II ubiquinol oxidase"	"appC" // "appB"	"APP-UBIOX-CPLX"
"GDP-mannose mannosyl hydrolase"	"gmm"	"CPLX0-7712"
"flagellar motor complex"	"fliN" // "fliM" // "fliG" // "flgH" // "motA" // "motB" // "flgB" // "flgC" // "flgF" // "flgG" // "flgI" // "fliF" // "fliE" // "fliL"	"FLAGELLAR-MOTOR-COMPLEX"
"agmatinase"	"speB"	"AGMATIN-CPLX"
"succinate-semialdehyde dehydrogenase (NADP<sup>+</sup>) GabD"	"gabD"	"CPLX0-7688"
"2,3-dihydro-2,3-dihydroxybenzoate dehydrogenase"	"entA"	"ENTA-CPLX"
"acetyl-CoA carboxyltransferase subunit &alpha;" // "acetyl-CoA carboxyltransferase subunit &beta;"	"accA" // "accD"	"ACETYL-COA-CARBOXYLTRANSFER-CPLX"
"&beta;-glucuronidase"	"uidA"	"CPLX0-7662"
"dihydroxy-acid dehydratase"	"ilvD"	"DIHYDROXYACIDDEHYDRAT-CPLX"
"putative D,D-dipeptide ABC transporter"	"ddpB" // "ddpC" // "ddpA" // "ddpD" // "ddpF"	"ABC-59-CPLX"
"Zn<sup>2+</sup>/Fe<sup>2+</sup>/Cd<sup>2+</sup> exporter"	"fieF"	"CPLX0-7641"
"D-alanine&mdash;D-alanine ligase B"	"ddlB"	"DALADALALIGB-CPLX"
"L-arginine ABC transporter"	"artJ" // "artQ" // "artM" // "artP"	"ABC-4-CPLX"
"ATP phosphoribosyltransferase"	"hisG"	"CPLX0-7614"
"MazE antitoxin of the MazF-MazE toxin-antitoxin system / DNA-binding transcriptional repressor"	"mazE"	"CPLX0-841"
"Ni(2+) ABC transporter"	"nikD" // "nikE" // "nikB" // "nikC" // "nikA"	"ABC-20-CPLX"
"polysaccharide export complex"	"wza" // "wzc"	"CPLX0-7529"
"OmpR dimer"	"ompR"	"CPLX0-8285"
"&beta;-ketoacyl-[acyl carrier protein] synthase II"	"fabF"	"3-OXOACYL-ACP-SYNTHII-CPLX"
"tRNA (cytidine/uridine-2'-<i>O</i>)-ribose methyltransferase"	"trmL"	"CPLX0-7421"
"2-amino-6-<i>N</i>-hydroxylaminopurine resistance protein"	"yiiM"	"CPLX0-8259"
"<I>Eco</I>KI restriction-modification system"	"hsdM" // "hsdR" // "hsdS"	"CPLX0-3958"
"pseudouridine-5'-phosphate glycosidase"	"psuG"	"CPLX0-8233"
"GroEL-GroES chaperonin complex"	"groL" // "groS"	"CPLX0-3934"
"S6:S18 ribosomal subunit complex"	"rpsR" // "rpsF"	"CPLX0-8208"
"uracil phosphoribosyltransferase"	"upp"	"URACIL-PRIBOSYLTRANS-CPLX"
"HypA-HypB heterodimer"	"hypA" // "hypB"	"CPLX0-3821"
"periplasmic serine endoprotease"	"degQ"	"CPLX0-8187"
"multidrug efflux pump MdtABC-TolC"	"tolC" // "mdtC" // "mdtB" // "mdtA"	"TRANS-CPLX-202"
"ribonuclease BN"	"rbn"	"CPLX0-3601"
"molybdopterin-synthase adenylyltransferase"	"moeB"	"CPLX0-8164"
"DnaA initiator-associating factor for replication initiation"	"diaA"	"CPLX0-3221"
"aminopeptidase B"	"pepB"	"CPLX0-8122"
"peptidoglycan DD-endopeptidase/peptidoglycan LD-endopeptidase"	"mepA"	"CPLX0-3201"
"putative PTS enzyme II FryBCA"	"fryC" // "fryB" // "fryA"	"CPLX0-8119"
"resolvasome"	"ruvC" // "ruvB" // "ruvA"	"RUVABC-CPLX"
"peptidase D"	"pepD"	"CPLX0-3001"
"peptide antibiotic/peptide nucleic acid transporter"	"sbmA"	"CPLX0-8097"
"fused DNA-binding transcriptional repressor / proline dehydrogenase / 1-pyrroline-5-carboxylate dehydrogenase PutA"	"putA"	"PUTA-CPLX"
"DNA-binding transcriptional dual regulator ModE"	"modE"	"CPLX0-2541"
"ethanol dehydrogenase / alcohol dehydrogenase"	"adhP"	"CPLX0-8015"
"dimer of DNA topoisomerase IV subunit A"	"parC"	"CPLX0-2423"
"lipopolysaccharide transport system"	"lptE" // "lptD" // "lptG" // "lptC" // "lptA" // "lptB" // "lptF"	"CPLX0-7992"
"phosphoenolpyruvate synthetase"	"ppsA"	"PEPSYNTH-CPLX"
"FMNH<sub>2</sub>-dependent alkanesulfonate monooxygenase"	"ssuD"	"CPLX0-225"
"cell division factor ZapD"	"zapD"	"CPLX0-7973"
"phosphoadenosine phosphosulfate reductase"	"cysH"	"PAPSSULFOTRANS-CPLX"
"enamine/imine deaminase, redox-regulated chaperone"	"ridA"	"CPLX0-1881"
"ribosomal protein S6 modification protein"	"rimK"	"CPLX0-7946"
"NADH dehydrogenase (quinone)"	""	"NQOR-CPLX"
"2,3-diaminopropionate ammonia-lyase"	"ygeX"	"CPLX0-1401"
"nucleoid occlusion factor SlmA"	"slmA"	"CPLX0-7922"
"5,10-methylenetetrahydrofolate reductase"	"metF"	"METHYLENETHFREDUCT-CPLX"
"primosomal protein DnaT"	"dnaT"	"CPLX0-0"
"1,4-dihydroxy-2-naphthoyl-CoA synthase"	"menB"	"CPLX0-7882"
"low-specificity L-threonine aldolase"	"ltaE"	"LTAA-CPLX"
"N-acetylglucosamine-specific PTS enzyme II"	"nagE"	"CPLX-167"
"phosphoenolpyruvate synthetase regulatory protein"	"ppsR"	"CPLX0-7837"
"holo-[acyl-carrier-protein] synthase"	"acpS"	"HOLO-ACP-SYNTH-CPLX"
"fused chorismate mutase/prephenate dehydrogenase"	"tyrA"	"CHORISMUTPREPHENDEHYDROG-CPLX"
"putative multidrug efflux pump MdtNOP"	"mdtP" // "mdtO" // "mdtN"	"CPLX0-7807"
"glyoxalase I"	"gloA"	"GLYOXI-CPLX"
"ATP synthase F<sub>0</sub> complex - subunit b"	"atpF"	"ATPF-CPLX"
"DNA-binding transcriptional dual regulator MetR"	"metR"	"CPLX0-7759"
"glutamate synthase"	"gltD" // "gltB"	"GLUTAMATESYN-DIMER"
"aspartate-semialdehyde dehydrogenase"	"asd"	"ASP-SEMIALDEHYDE-DEHYDROGENASE-CPLX"
"tRNA pseudouridine<sup>38-40</sup> synthase"	"truA"	"CPLX0-7728"
"fumarase C"	"fumC"	"FUMARASE-C"
"anthranilate synthase subunit TrpE" // "anthranilate synthase subunit TrpD"	"trpE" // "trpD"	"ANTHRANSYN-CPLX"
"glutamate-putrescine ligase"	"puuA"	"CPLX0-7709"
"fatty acid oxidation complex, &alpha; component"	"fadB"	"FADB-CPLX"
"<i>S</i>-(hydroxymethyl)glutathione dehydrogenase"	"frmA"	"ADHC-CPLX"
"hypoxanthine phosphoribosyltransferase"	"hpt"	"CPLX0-7685"
"L-ascorbate specific PTS enzyme II"	"ulaC" // "ulaB" // "ulaA"	"EIISGA"
"acetolactate synthase II subunit IlvG, N-terminal fragment (pseudogene)" // "acetolactate synthase II subunit IlvM"	"ilvG" // "ilvM"	"ACETOLACTSYNII-CPLX"
"<i>N</i>-acetylneuraminate mutarotase"	"nanM"	"CPLX0-7658"
"dihydroorotase"	"pyrC"	"DIHYDROOROT-CPLX"
"aliphatic sulfonate ABC transporter"	"ssuA" // "ssuC" // "ssuB"	"ABC-56-CPLX"
"L-fucose isomerase"	"fucI"	"CPLX0-7631"
"cytochrome <i>bd</i>-I ubiquinol oxidase"	"cydA" // "cydB" // "cydX"	"CYT-D-UBIOX-CPLX"
"xylose ABC transporter"	"xylG" // "xylH" // "xylF"	"ABC-33-CPLX"
"putative xanthine dehydrogenase"	"xdhA" // "xdhB" // "xdhC"	"CPLX0-761"
"ubiquinone biosynthesis complex UbiUV"	"ubiV" // "ubiU"	"CPLX0-8308"
"D-galactose / methyl-&beta;-D-galactoside ABC transporter"	"mglA" // "mglC" // "mglB"	"ABC-18-CPLX"
"xylulokinase"	"xylB"	"CPLX0-7466"
"murein lipoprotein"	"lpp"	"CPLX0-8279"
"3-isopropylmalate dehydrogenase"	"leuB"	"3-ISOPROPYLMALDEHYDROG-CPLX"
"IS2 insertion element repressor InsA"	"insC-1"	"CPLX0-7417"
"D-alanyl-D-alanine carboxypeptidase DacC"	"dacC"	"CPLX0-8254"
"50S ribosomal subunit protein L7/L12 dimer"	"rplL"	"CPLX0-3955"
"HigB-HigA toxin/antitoxin complex and DNA-binding transcriptional repressor"	"higB" // "higA"	"CPLX0-8230"
"ATP-dependent DNA helicase Rep"	"rep"	"CPLX0-3931"
"UTP&mdash;glucose-1-phosphate uridylyltransferase"	"galU"	"CPLX0-8205"
"acyl-[acyl-carrier-protein]&mdash;UDP-<i>N</i>-acetylglucosamine <i>O</i>-acyltransferase"	"lpxA"	"UDPNACETYLGLUCOSAMACYLTRANS-CPLX"
"DNA polymerase III, preinitiation complex"	"dnaX" // "holB" // "holA"	"CPLX0-3801"
"nonspecific DNA-binding protein YbiB"	"ybiB"	"CPLX0-8184"
"triose-phosphate isomerase"	"tpiA"	"TPI"
"ATP-dependent RNA helicase RhlB"	"rhlB"	"CPLX0-3541"
"putrescine aminotransferase"	"patA"	"CPLX0-8159"
"assimilatory sulfite reductase (NADPH)"	"cysJ" // "cysI"	"SULFITE-REDUCT-CPLX"
"putative quinol monooxygenase YgiN"	"ygiN"	"CPLX0-3141"
"phosphate signaling protein PhoU"	"phoU"	"CPLX0-8113"
"ribonucleoside-diphosphate reductase 2"	"nrdE" // "nrdF"	"RIBONUCLEOSIDE-DIP-REDUCTII-CPLX"
"protease IV, a signal peptide peptidase"	"sppA"	"CPLX0-2941"
"negative regulator of MalT activity/cystathionine &beta;-lyase"	"malY"	"CPLX0-8092"
"phosphoserine/phosphohydroxythreonine aminotransferase"	"serC"	"PSERTRANSAM-CPLX"
"protein MoaB"	"moaB"	"CPLX0-2521"
"dTDP-glucose pyrophosphorylase 2"	"rffH"	"CPLX0-8012"
"tryptophan synthase, &beta; subunit dimer"	"trpB"	"CPLX0-2401"
"PaaF-PaaG hydratase-isomerase complex"	"paaG" // "paaF"	"CPLX0-7988"
"pyridoxine/pyridoxamine 5'-phosphate oxidase"	"pdxH"	"PDXH-CPLX"
"tripartite efflux pump EmrKY-TolC"	"tolC" // "emrK" // "emrY"	"CPLX0-2161"
"multidrug efflux pump EmrE / betaine:H<sup>+</sup> antiporter / choline:H<sup>+</sup> antiporter"	"emrE"	"CPLX0-7963"
"aminodeoxychorismate synthase subunit 1" // "aminodeoxychorismate synthase subunit 2"	"pabB" // "pabA"	"PABASYN-CPLX"
"oligoribonuclease"	"orn"	"CPLX0-1821"
"Grx4-BolA complex"	"bolA" // "grxD"	"CPLX0-7942"
"nitrate reductase A"	"narG" // "narH" // "narI"	"NITRATREDUCTA-CPLX"
"D-arabinose 5-phosphate isomerase KdsD"	"kdsD"	"CPLX0-1262"
"RcsB-BglJ DNA-binding transcriptional activator"	"bglJ" // "rcsB"	"CPLX0-7916"
"isochorismate synthase MenF"	"menF"	"MENF-CPLX"
"cyclic pyranopterin monophosphate synthase"	"moaC"	"CPLX-8331"
"glucose-6-phosphate isomerase"	"pgi"	"CPLX0-7877"
"L-glutamine&mdash;D-fructose-6-phosphate aminotransferase"	"glmS"	"L-GLN-FRUCT-6-P-AMINOTRANS-CPLX"
"putative PTS enzyme II FrwCBDPtsA"	"frwC" // "frwB" // "frwD" // "ptsA"	"CPLX-160"
"carboxylate-amine ligase"	"ybdK"	"CPLX0-7827"
"histidinal/histidinol dehydrogenase"	"hisD"	"HISTDEHYD-CPLX"
"cyclopropane fatty acyl phospholipid synthase"	"cfa"	"CFA-CPLX"
"diguanylate cyclase DgcZ"	"dgcZ"	"CPLX0-7802"
"glycerophosphoryl diester phosphodiesterase, periplasmic"	"glpQ"	"GLYCPDIESTER-PERI-CPLX"
"K<sup>+</sup> transporting P-type ATPase"	"kdpF" // "kdpA" // "kdpB" // "kdpC"	"ATPASE-1-CPLX"
"DNA-binding transcriptional repressor NsrR"	"nsrR"	"CPLX0-7756"
"glucosamine-6-phosphate deaminase"	"nagB"	"GLUCOSAMINE-6-P-DEAMIN-CPLX"
"asparagine&mdash;tRNA ligase"	"asnS"	"ASNS-CPLX"
"CRISPR-associated complex for antiviral defense"	"casA" // "casB" // "casC" // "casD" // "casE"	"CPLX0-7725"
"fructose-bisphosphate aldolase class II"	"fbaA"	"FRUCBISALD-CLASSII"
"anaerobic glycerol-3-phosphate dehydrogenase"	"glpA" // "glpB" // "glpC"	"ANGLYC3PDEHYDROG-CPLX"
"DNA-binding transcriptional dual regulator Fis"	"fis"	"CPLX0-7705"
"&beta;-ketoacyl-[acyl carrier protein] synthase I"	"fabB"	"FABB-CPLX"
"adenine phosphoribosyltransferase"	"apt"	"ADENPRIBOSYLTRAN-CPLX"
"iron-sulfur cluster carrier protein NfuA"	"nfuA"	"CPLX0-7682"
"pyruvate dehydrogenase"	"aceE"	"E1P-CPLX"
"ferric citrate ABC transporter"	"fecE" // "fecC" // "fecD" // "fecB"	"ABC-9-CPLX"
"glycerol facilitator"	"glpF"	"CPLX0-7654"
"diacylglycerol kinase"	"dgkA"	"DIACYLGLYKIN-CPLX"
"putative transport complex, ABC superfamily"	"yhdZ" // "yhdY" // "yhdX" // "yhdW"	"ABC-52-CPLX"
"lipopolysaccharide transport system - outer membrane assembly complex"	"lptD" // "lptE"	"CPLX0-7628"
"cyanase"	"cynS"	"CYANLY-CPLX"
"lysine / arginine / ornithine ABC transporter"	"hisQ" // "hisP" // "hisM" // "argT"	"ABC-3-CPLX"
"5-carboxymethylaminomethyluridine-tRNA synthase subunit MnmG"	"mnmG"	"CPLX0-7597"
"DcuS-DcuB sensor complex"	"dcuB" // "dcuS"	"CPLX0-8304"
"histidine ABC transporter"	"hisP" // "hisM" // "hisQ" // "hisJ"	"ABC-14-CPLX"
"glycolate dehydrogenase"	"glcD" // "glcE" // "glcF"	"CPLX0-7458"
"F<sup>-</sup> channel"	"crcB"	"CPLX0-8271"
"N-acetylmuramic acid-specific PTS enzyme II"	"murP" // "crr"	"CPLX0-7"
"5-oxoprolinase"	"pxpC" // "pxpB" // "pxpA"	"CPLX0-8249"
"peptidoglycan glycosyltransferase / peptidoglycan DD-transpeptidase MrcB"	"mrcB"	"CPLX0-3951"
"FicT-FicA complex"	"fic" // "yhfG"	"CPLX0-8227"
"regulatory ATPase RavA"	"ravA"	"CPLX0-3927"
"glutarate hydroxylase GlaH"	"glaH"	"CPLX0-8201"
"tyrosine&mdash;tRNA ligase"	"tyrS"	"TYRS-CPLX"
"N<sup>6</sup>-L-threonylcarbamoyladenine synthase, TsaB-TsaD dimer subunit"	"tsaB" // "tsaD"	"CPLX0-8181"
"thymidylate synthase"	"thyA"	"THYMIDYLATESYN-CPLX"
"aldehyde dehydrogenase B"	"aldB"	"CPLX0-3482"
"Xaa-Pro dipeptidase"	"pepQ"	"CPLX0-8156"
"succinyl-CoA synthetase subunit &alpha;" // "succinyl-CoA synthetase subunit &beta;"	"sucD" // "sucC"	"SUCCCOASYN"
"ClpXP"	"clpP" // "clpX"	"CPLX0-3107"
"molybdenum cofactor insertion chaperone PaoD"	"paoD"	"CPLX0-8110"
"ribose-5-phosphate isomerase A"	"rpiA"	"RIB5PISOMA-CPLX"
"Lon protease"	"lon"	"CPLX0-2881"
"proline&mdash;tRNA ligase"	"proS"	"PROS-CPLX"
"molybdopterin synthase"	"moaD" // "moaE"	"CPLX0-2502"
"periplasmic acid stress chaperone HdeA"	"hdeA"	"CPLX0-801"
"argininosuccinate synthetase"	"argG"	"CPLX0-238"
"miniconductance mechanosensitive channel MscM"	"mscM"	"CPLX0-7985"
"RcsAB DNA-binding transcriptional dual regulator"	"rcsB" // "rcsA"	"PC00084"
"dihydroxyacetone kinase"	"dhaK" // "dhaL" // "dhaM"	"CPLX0-2081"
"protein/nucleic acid deglycase 3"	"yajL"	"CPLX0-7960"
"ornithine decarboxylase, degradative"	"speF"	"ORNDECARBOXDEG-CPLX"
"adenine deaminase"	"adeD"	"CPLX0-1683"
"PTS enzyme I"	"ptsI"	"CPLX0-7938"
"periplasmic nitrate reductase"	"napB" // "napA"	"NAP-CPLX"
"MazF toxin of the MazF-MazE toxin-antitoxin system that exhibits ribonuclease activity"	"mazF"	"CPLX0-1241"
"phosphate acetyltransferase EutD"	"eutD"	"CPLX0-7912"
"NADP<sup>+</sup>-dependent malate dehydrogenase"	"maeB"	"MALIC-NADP-CPLX"
"arsenite/antimonite:H<sup>+</sup> antiporter"	"arsB"	"CPLX-7"
"Der GTPase-activating protein YihI"	"yihI"	"CPLX0-7853"
"3-deoxy-D-<i>manno</i>-octulosonate 8-phosphate synthase"	"kdsA"	"KDO-8PSYNTH-CPLX"
"glucose-specific PTS enzyme II"	"ptsG" // "crr"	"CPLX-157"
"DosC-DosP complex"	"dosP" // "dosC"	"CPLX0-7823"
"dihydropteroate synthase"	"folP"	"H2PTEROATESYNTH-CPLX"
"carbonic anhydrase 1"	"cynT"	"CARBODEHYDRAT-CPLX"
"MetJ-S-adenosylmethionine DNA-binding transcriptional repressor"	"metJ"	"CPLX0-7796"
"L-1,2-propanediol dehydrogenase / glycerol dehydrogenase"	"gldA"	"GLYCDEH-CPLX"
"&beta; complex"	"atoA"	"ATOA-CPLX"
"CpxR-P<sup>asp</sup> DNA-binding transcriptional dual regulator"	"cpxR"	"CPLX0-7748"
"sensory histidine kinase NtrB"	"glnL"	"GLNL-CPLX"
"3-deoxy-7-phosphoheptulonate synthase, Tyr-sensitive"	"aroF"	"AROF-CPLX"
"L-rhamnonate dehydratase"	"rhmD"	"CPLX0-7722"
"hydrogenase 1"	"hyaA" // "hyaB" // "hyaC"	"FORMHYDROGI-CPLX"
"&alpha;-galactosidase"	"melA"	"ALPHAGALACTOSID-CPLX"
"MukEF complex"	"mukE" // "mukF"	"CPLX0-7697"
"ATP synthase F<sub>0</sub> complex"	"atpE" // "atpF" // "atpB"	"F-O-CPLX"
"cysteine synthase B"	"cysM"	"ACSERLYB-CPLX"
"2Fe-2S cluster-containing protein YeaW"	"yeaW"	"CPLX0-7675"
"dUTP diphosphatase"	"dut"	"DUTP-PYROP-CPLX"
"thiosulfate/sulfate ABC transporter"	"cysA" // "cysW" // "cysU" // "cysP"	"ABC-7-CPLX"
"L-rhamnose mutarotase"	"rhaM"	"CPLX0-7649"
"dethiobiotin synthetase"	"bioD"	"DETHIOBIOTIN-SYN-CPLX"
"glutathione ABC transporter"	"gsiA" // "gsiB" // "gsiD" // "gsiC"	"ABC-49-CPLX"
"dCMP phosphohydrolase"	"yfbR"	"CPLX0-7625"
"NMN aminohydrolase"	"pncC"	"CPLXECOLI-7943"
"phosphate ABC transporter"	"pstB" // "pstA" // "pstC" // "pstS"	"ABC-27-CPLX"
"cell division protein ZapA"	"zapA"	"CPLX0-7538"
"Ubi complex"	"ubiK" // "ubiJ" // "ubiI" // "ubiH" // "ubiG" // "ubiF" // "ubiE"	"CPLX0-8301"
"iron(III) hydroxamate ABC transporter"	"fhuC" // "fhuB" // "fhuD"	"ABC-11-CPLX"
"flagellar motor switch complex"	"fliG" // "fliM" // "fliN"	"CPLX0-7450"
"aromatic carboxylic acid efflux pump"	"aaeA" // "aaeB"	"CPLX0-4"
"regulator of CsrB and CsrC decay"	"csrD"	"CPLX0-8245"
"ITPase/XTPase"	"yjjX"	"CPLX0-3948"
"diguanylate cyclase DosC"	"dosC"	"CPLX0-8218"
"putative monooxygenase YdhR"	"ydhR"	"CPLX0-3923"
"lipoprotein NlpI"	"nlpI"	"CPLX0-8198"
"tryptophan synthase subunit &alpha;" // "tryptophan synthase, &beta; subunit dimer"	"trpA" // "trpB"	"TRYPSYN"
"glutamyl-tRNA reductase"	"hemA"	"CPLX0-3741"
"tRNA threonylcarbamoyladenosine dehydratase"	"tcdA"	"CPLX0-8176"
"threonine deaminase"	"ilvA"	"THREDEHYDSYN-CPLX"
"fimbrial complex"	"fimA" // "fimF" // "fimG" // "fimH"	"CPLX0-3401"
"cystine ABC transporter"	"tcyN" // "tcyL" // "tcyJ"	"CPLX0-8152"
"spermidine <i>N</i>-acetyltransferase"	"speG"	"SPERMACTRAN-CPLX"
"ClpP serine protease"	"clpP"	"CPLX0-3101"
"small heat shock protein IbpB homodimer"	"ibpB"	"CPLX0-8107"
"exodeoxyribonuclease V"	"recD" // "recC" // "recB"	"RECBCD"
"ClpXP protease specificity-enhancing factor"	"sspB"	"CPLX0-2681"
"molybdopterin-guanine dinucleotide biosynthesis adaptor protein"	"mobB"	"CPLX0-8044"
"polyphosphate kinase"	"ppk"	"PPK-CPLX"
"L-cysteine desulfurase"	"sufS"	"CPLX0-246"
"enoyl-[acyl-carrier-protein] reductase"	"fabI"	"CPLX0-8006"
"phosphatidylserine decarboxylase"	"psd"	"PHOSPHASERDECARB-DIMER"
"arylamine <i>N</i>-acetyltransferase"	"nhoA"	"CPLX0-236"
"small conductance mechanosensitive channel YnaI"	"ynaI"	"CPLX0-7982"
"DNA-binding transcriptional repressor PurR"	"purR"	"PC00033"
"fructose-6-phosphate aldolase 1"	"fsaA"	"CPLX0-201"
"selenide, water dikinase"	"selD"	"CPLX0-7957"
"ornithine carbamoyltransferase"	"argF"	"ORNCARBAMTRANSFERF-CPLX"
"RNase G"	"rng"	"CPLX0-1621"
"FtsLBQ cell division complex"	"ftsQ" // "ftsB" // "ftsL"	"CPLX0-7934"
"NADH:quinone oxidoreductase I"	"nuoA" // "nuoH" // "nuoJ" // "nuoK" // "nuoL" // "nuoM" // "nuoN" // "nuoI" // "nuoG" // "nuoF" // "nuoE" // "nuoC" // "nuoB"	"NADH-DHI-CPLX"
"HslV hexamer"	"hslV"	"CPLX0-1162"
"iron-sulfur cluster insertion protein IscA"	"iscA"	"CPLX0-7908"
"malate dehydrogenase"	"mdh"	"MALATE-DEHASE"
"curli transport specificity factor" // "curli secretion channel"	"csgE" // "csgG"	"CPLX-3945"
"L-ascorbate-6-phosphate lactonase"	"ulaG"	"CPLX0-7848"
"inosine 5'-monophosphate dehydrogenase"	"guaB"	"IMP-DEHYDROG-CPLX"
"&beta;-glucoside specific PTS enzyme II / BglG kinase / BglG phosphatase"	"bglF"	"CPLX-154"
"lipoyl synthase"	"lipA"	"CPLX0-782"
"glutathione <i>S</i>-transferase GstA"	"gstA"	"GST-CPLX"
"biotin carboxylase"	"accC"	"BIOTIN-CARBOXYL-CPLX"
"RelB-RelE antitoxin/toxin complex / DNA-binding transcriptional repressor"	"relB" // "relE"	"CPLX0-7791"
"glutamate 5-kinase"	"proB"	"GLUTKIN-CPLX"
"fused aspartate kinase/homoserine dehydrogenase 2"	"metL"	"ASPKINIIHOMOSERDEHYDROGII-CPLX"
"3-keto-L-gulonate-6-phosphate decarboxylase UlaD"	"ulaD"	"CPLX0-7744"
"glycine decarboxylase"	"gcvP"	"GCVP-CPLX"
"arginine decarboxylase, degradative"	"adiA"	"ARGDECARBOXDEG-CPLX"
"quinolinate synthase"	"nadA"	"CPLX0-7719"
"formate dehydrogenase N, subcomplex"	"fdnG" // "fdnH" // "fdnI"	"FORMATEDEHYDROGN-CPLX"
"aldehyde dehydrogenase A, NAD-linked"	"aldA"	"ALD-CPLX"
"glutaminase 1"	"glsA"	"CPLX0-7694"
"D-erythrose-4-phosphate dehydrogenase"	"epd"	"ERYTH4PDEHYDROG-CPLX"
"<i>N</i>-acetylneuraminate lyase"	"nanA"	"ACNEULY-CPLX"
"DNA-binding transcriptional dual regulator ArgP"	"argP"	"CPLX0-7669"
"protein disulfide isomerase DsbC"	"dsbC"	"DSBC-CPLX"
"lipoprotein release complex"	"lolE" // "lolD" // "lolC"	"ABC-62-CPLX"
"D-ribose pyranase"	"rbsD"	"CPLX0-7646"
"D-cysteine desulfhydrase"	"dcyD"	"DCYSDESULF-CPLX"
"intermembrane phospholipid transport system"	"mlaB" // "mlaD" // "mlaE" // "mlaF"	"ABC-45-CPLX"
"L-serine deaminase III"	"tdcG"	"CPLX0-7622"
"putative 4-oxalocrotonate tautomerase (4-OT)"	"pptA"	"CPLX0-902"
"spermidine preferential ABC transporter"	"potA" // "potB" // "potC" // "potD"	"ABC-24-CPLX"
"outer membrane porin F"	"ompF"	"CPLX0-7534"
"5-keto-D-gluconate 5-reductase"	"idnO"	"CPLX0-8292"
"7-&alpha;-hydroxysteroid dehydrogenase"	"hdhA"	"7-ALPHA-HYDROXYSTEROID-DEH-CPLX"
"<i>all-trans</i>-octaprenyl-diphosphate synthase"	"ispB"	"CPLX0-7426"
"guanidinium exporter"	"gdx"	"CPLX0-8263"
"murein tripeptide ABC transporter"	"oppB" // "oppC" // "oppD" // "oppF" // "mppA"	"CPLX0-3970"
"Grx4-IbaG complex"	"ibaG" // "grxD"	"CPLX0-8239"
"universal stress protein G"	"uspG"	"CPLX0-3939"
"periplasmic protein-L-methionine sulfoxide reducing system"	"msrQ" // "msrP"	"CPLX0-8213"
"xylose isomerase"	"xylA"	"XYLISOM-CPLX"
"&alpha;-D-xyloside xylohydrolase"	"yicI"	"CPLX0-3901"
"chaperone protein DnaJ"	"dnaJ"	"CPLX0-8191"
"trans-2-enoyl-CoA reductase (NADPH)"	""	"TRANSENOYLCOARED-CPLX"
"fused heptose 7-phosphate kinase/heptose 1-phosphate adenyltransferase"	"hldE"	"CPLX0-3661"
"CRISPR-associated endoribonuclease Cas2"	"cas2"	"CPLX0-8173"
"acyl-CoA thioesterase II"	"tesB"	"THIOESTERII-CPLX"
"holocytochrome <I>c</I> synthetase"	"ccmE" // "ccmF" // "ccmG" // "ccmH"	"CPLX0-3323"
"2-hydroxycyclohepta-1,4,6-triene-1-carboxyl-CoA thioesterase"	"paaY"	"CPLX0-8127"
"serine&mdash;tRNA ligase"	"serS"	"SERS-CPLX"
"Sec Holo-Translocon"	"secD" // "secF" // "yajC" // "yidC" // "secY" // "secG" // "secE"	"SEC-SECRETION-CPLX"
"peptidase T"	"pepT"	"CPLX0-3041"
"methyl-accepting chemotaxis protein - dipeptide-sensing"	"tap"	"CPLX0-8104"
"pyruvate oxidase"	"poxB"	"PYRUVOXID-CPLX"
"isoaspartyl dipeptidase / asparaginase III"	"iaaA"	"CPLX0-263"
"acetylesterase"	"aes"	"CPLX0-8033"
"pyruvate kinase I"	"pykF"	"PKI-COMPLEX"
"NADPH-dependent nitroreductase NfsA"	"nfsA"	"CPLX0-244"
"RNase adaptor protein"	"rapZ"	"CPLX0-7998"
"sensor histidine kinase PhoR"	"phoR"	"PHOR-CPLX"
"galactitol-specific PTS enzyme II"	"gatC" // "gatB" // "gatA"	"CPLX0-231"
"16S rRNA m<sup>4</sup>C1402 methyltransferase"	"rsmH"	"CPLX0-7977"
"DNA-binding transcriptional repressor TrpR"	"trpR"	"PC00007"
"ferrichrome outer membrane transport complex"	"exbD" // "exbB" // "tonB" // "fhuA"	"CPLX0-1942"
"ferric coprogen outer membrane transport complex"	"fhuE" // "exbD" // "exbB" // "tonB"	"CPLX0-7952"
"periplasmic nitrite reductase NrfAB"	"nrfA" // "nrfB"	"NRFMULTI-CPLX"
"stationary phase nucleoid component that sequesters iron and protects DNA from damage"	"dps"	"CPLX0-1521"
"antitoxin/DNA-binding transcriptional repressor YefM"	"yefM"	"CPLX0-7929"
"MutHLS complex, methyl-directed mismatch repair"	"mutL" // "mutS" // "mutH"	"MUTHLS-CPLX"
"selenocysteine synthase"	"selA"	"CPLX0-1141"
"EF-P-lysine lysyltransferase"	"epmA"	"CPLX0-7889"
"lysine&mdash;tRNA ligase, constitutive"	"lysS"	"LYSS-CPLX"
"hydroxypyruvate isomerase"	"hyi"	"CPLX-171"
"formate channel FocA"	"focA"	"CPLX0-7843"
"catalase/hydroperoxidase HPI"	"katG"	"HYDROPEROXIDI-CPLX"
"pantetheine-phosphate adenylyltransferase"	"coaD"	"COADTRI-CPLX"
"putative nucleoid-associated protein YbaB"	"ybaB"	"CPLX0-7816"
"xanthine-guanine phosphoribosyltransferase"	"gpt"	"GPT-CPLX"
"betaine aldehyde dehydrogenase"	"betB"	"BADH-CPLX"
"DinJ-YafQ antitoxin/toxin complex / DNA-binding transcriptional repressor"	"yafQ" // "dinJ"	"CPLX0-7787"
"glutathione synthetase"	"gshB"	"GLUTATHIONE-SYN-CPLX"
"aspartate carbamoyltransferase, regulatory subunit"	"pyrI"	"ASPCARBREG-DIMER"
"DNA-binding transcriptional repressor ArsR"	"arsR"	"CPLX0-7734"
"galactose-1-phosphate uridylyltransferase"	"galT"	"GALACTURIDYLYLTRANS-CPLX"
"L-arabinose isomerase"	"araA"	"ARABISOM-CPLX"
"DNA-binding transcriptional dual regulator DsdC"	"dsdC"	"CPLX0-7713"
"bifunctional 5,10-methylene-tetrahydrofolate dehydrogenase/ 5,10-methylene-tetrahydrofolate cyclohydrolase"	"folD"	"FOLD-CPLX"
"phosphoribosylformylglycinamide cyclo-ligase"	"purM"	"AIRS-CPLX"
"isovaleryl-CoA dehydrogenase and DNA-binding transcriptional repressor"	"aidB"	"CPLX0-7691"
"2,3-dihydroxybenzoate-[aryl-carrier protein] ligase"	"entE"	"ENTE-CPLX"
"acetylglutamate kinase"	"argB"	"ACETYLGLUTKIN-CPLX"
"DNA-binding transcriptional activator CaiF"	"caiF"	"CPLX0-7666"
"dimethyl sulfoxide reductase subunit A" // "dimethyl sulfoxide reductase subunit B" // "dimethyl sulfoxide reductase subunit C"	"dmsA" // "dmsB" // "dmsC"	"DIMESULFREDUCT-CPLX"
"glutathione / L-cysteine ABC exporter CydDC"	"cydD" // "cydC"	"ABC-6-CPLX"
"osmolyte:H<sup>+</sup> symporter ProP"	"proP"	"CPLX0-7642"
"D-amino acid dehydrogenase"	"dadA"	"DALADEHYDROG-CPLX"
"glycine betaine ABC transporter, non-osmoregulatory"	"osmF" // "yehY" // "yehX" // "yehW"	"ABC-40-CPLX"
"&alpha;-dehydro-&beta;-deoxy-<i>D</i>-glucarate aldolase"	"garL"	"CPLX0-7615"
"protein/nucleic acid deglycase 1"	"hchA"	"CPLX0-861"
"putative transport complex, ABC superfamily"	"yadG" // "yadH"	"ABC-21-CPLX"
"outer membrane porin PhoE"	"phoE"	"CPLX0-7530"
"sensor histidine kinase CusS"	"cusS"	"CPLX0-8288"
"6-phosphofructokinase 1"	"pfkA"	"6PFK-1-CPX"
"predicted rRNA methyltransferase"	"yjtD"	"CPLX0-7422"
"dTMP kinase"	"tmk"	"CPLX0-8260"
"Xer site-specific recombination system"	"xerC" // "xerD"	"CPLX0-3959"
"DNA-binding transcriptional repressor FrmR"	"frmR"	"CPLX0-8234"
"dihydroneopterin aldolase"	"folB"	"CPLX0-3936"
"fructoselysine 6-phosphate deglycase"	"frlB"	"CPLX0-821"
"uridine phosphorylase"	"udp"	"URPHOS-CPLX"
"4-(cytidine 5'-diphospho)-2-<i>C</i>-methyl-D-erythritol kinase"	"ispE"	"CPLX0-3841"
"Z-ring inhibitor complex MinCD"	"minD" // "minC"	"CPLX0-8188"
"2,3-diketo-L-gulonate:Na<sup>+</sup> symporter - periplasmic binding protein" // "2,3-diketo-L-gulonate:Na<sup>+</sup> symporter - membrane subunit" // "2,3-diketo-L-gulonate:Na<sup>+</sup> symporter - membrane subunit"	"yiaO" // "yiaN" // "yiaM"	"TRANS-CPLX-203"
"RNase T"	"rnt"	"CPLX0-3602"
"ssDNA-binding protein"	"ssb"	"CPLX0-8165"
"ubiquinol&mdash;[NapC cytochrome <i>c</i>] reductase NapGH"	"napG" // "napH"	"CPLX0-3241"
"6-carboxy-5,6,7,8-tetrahydropterin synthase"	"queD"	"CPLX0-8123"
"putative ABC transporter ArtPQMI"	"artI" // "artM" // "artQ" // "artP"	"CPLX0-8120"
"methionine adenosyltransferase"	"metK"	"S-ADENMETSYN-CPLX"
"3-octaprenyl-4-hydroxybenzoate decarboxylase"	"ubiD"	"CPLX0-301"
"UDP-glucose 6-dehydrogenase"	"ugd"	"CPLX0-8098"
"pyridine nucleotide transhydrogenase subunit &beta;" // "pyridine nucleotide transhydrogenase subunit &alpha;"	"pntB" // "pntA"	"PYRNUTRANSHYDROGEN-CPLX"
"phenylhydantoinase"	"hyuA"	"CPLX0-255"
"UDP-3-<i>O</i>-(3-hydroxymyristoyl)glucosamine <i>N</i>-acyltransferase"	"lpxD"	"CPLX0-8016"
"DNA topoisomerase IV"	"parE" // "parC"	"CPLX0-2424"
"ureidoglycolate dehydrogenase"	"allD"	"CPLX0-7993"
"phosphoglycerate dehydrogenase"	"serA"	"PGLYCDEHYDROG-CPLX"
"&alpha;-ketoglutarate-dependent taurine dioxygenase"	"tauD"	"CPLX0-227"
"RNA decapping hydrolase"	"nudC"	"CPLX0-7974"
"DNA-binding transcriptional dual regulator AraC"	"araC"	"PC00003"
"energy transducing Ton complex"	"tonB" // "exbB" // "exbD"	"CPLX0-1923"
"<i>N</i>-succinylarginine dihydrolase"	"astB"	"CPLX0-7947"
"anaerobic nucleoside-triphosphate reductase activating system"	"nrdD" // "nrdG"	"NRDACTMULTI-CPLX"
"bacterioferritin"	"bfr"	"CPLX0-1421"
"ATP-independent periplasmic chaperone"	"spy"	"CPLX0-7923"
"L-methionine/D-methionine ABC transporter"	"metN" // "metI" // "metQ"	"METNIQ-METHIONINE-ABC-CPLX"
"2-methylisocitrate lyase"	"prpB"	"CPLX0-1021"
"glutathione hydrolase"	"ggt"	"CPLX0-7885"
"L(+)-tartrate dehydratase subunit &alpha;" // "L(+)-tartrate dehydratase subunit &beta;"	"ttdA" // "ttdB"	"LTARTDEHYDRA-CPLX"
"trehalose-specific PTS enzyme II"	"treB" // "crr"	"CPLX-168"
"cysteine sulfinate desulfinase"	"csdA"	"CPLX0-7838"
"homoserine kinase"	"thrB"	"HOMOSERKIN-CPLX"
"citrate synthase"	"gltA"	"CITRATE-SI-SYNTHASE"
"coproporphyrinogen III oxidase"	"hemF"	"CPLX0-7808"
"glycine&mdash;tRNA ligase"	"glyS" // "glyQ"	"GLYS-CPLX"
"ATP synthase F<sub>0</sub> complex" // "ATP synthase F<sub>1</sub> complex"	"atpB" // "atpF" // "atpE" // "atpD" // "atpG" // "atpA" // "atpH" // "atpC"	"ATPSYN-CPLX"
"aconitate hydratase A"	"acnA"	"CPLX0-7760"
"imidazole glycerol phosphate synthase subunit HisH" // "imidazole glycerol phosphate synthase subunit HisF"	"hisH" // "hisF"	"GLUTAMIDOTRANS-CPLX"
"aspartate aminotransferase"	"aspC"	"ASPAMINOTRANS-DIMER"
"DNA-binding transcriptional repressor PaaX"	"paaX"	"CPLX0-7731"
"fumarate reductase flavoprotein subunit" // "fumarate reductase iron-sulfur protein" // "fumarate reductase membrane protein FrdC" // "fumarate reductase membrane protein FrdD"	"frdA" // "frdB" // "frdC" // "frdD"	"FUMARATE-REDUCTASE"
"acid phosphatase / phosphotransferase"	"aphA"	"APHA-CPLX"
"DNA-binding transcriptional repressor MarR"	"marR"	"CPLX0-7710"
"aerobic fatty acid oxidation complex"	"fadB" // "fadA"	"FAO-CPLX"
"alcohol dehydrogenase/aldehyde-dehydrogenase"	"adhE"	"ADHE-CPLX"
"cell division factor ZapB"	"zapB"	"CPLX0-7686"
"putative PTS enzyme II SgcBCA"	"sgcB" // "sgcC" // "sgcA"	"EIISGC"
"acetolactate synthase / acetohydroxybutanoate synthase, catalytic subunit" // "acetolactate synthase / acetohydroxybutanoate synthase, regulatory subunit"	"ilvI" // "ilvH"	"ACETOLACTSYNIII-CPLX"
"fused diaminohydroxyphosphoribosylaminopyrimidine deaminase / 5-amino-6-(5-phosphoribosylamino)uracil reductase"	"ribD"	"CPLX0-7659"
"4-hydroxy-tetrahydrodipicolinate reductase"	"dapB"	"DIHYDROPICRED-CPLX"
"putative ABC exporter YbhFSR"	"ybhS" // "ybhR" // "ybhF"	"ABC-57-CPLX"
"NAD(P)H:quinone oxidoreductase"	"wrbA"	"CPLX0-7632"
"cytochrome <i>bo<sub>3</sub></i> ubiquinol oxidase"	"cyoD" // "cyoA" // "cyoB" // "cyoC"	"CYT-O-UBIOX-CPLX"
"<i>sn</i>-glycerol 3-phosphate / glycerophosphodiester ABC transporter"	"ugpC" // "ugpA" // "ugpE" // "ugpB"	"ABC-34-CPLX"
"<I>N</I>-acetyl-D-galactosamine specific PTS (cryptic)"	"agaV" // "agaW"	"CPLX0-7610"
"ribosome-dependent mRNA interferase toxin YoeB"	"yoeB"	"CPLX0-8311"
"molybdate ABC transporter"	"modC" // "modB" // "modA"	"ABC-19-CPLX"
"carbonic anhydrase 2"	"can"	"CPLX0-7521"
"pyrimidine-specific ribonucleoside hydrolase RihA"	"rihA"	"CPLX0-8280"
"3-isopropylmalate dehydratase"	"leuC" // "leuD"	"3-ISOPROPYLMALISOM-CPLX"
"DNA-binding transcriptional repressor MprA"	"mprA"	"CPLX0-7418"
"Mlc-PtsG"	"ptsG" // "mlc"	"CPLX0-8255"
"50S ribosomal protein complex L8"	"rplJ" // "rplL"	"CPLX0-3956"
"16S rRNA 2'-<i>O</i>-ribose C1402 methyltransferase"	"rsmI"	"CPLX0-8231"
"multidrug efflux pump AcrAD-TolC"	"tolC" // "acrD" // "acrA"	"CPLX0-3932"
"dihydroxyacetone kinase, phosphotransferase component"	"dhaM"	"CPLX0-8206"
"UMP kinase"	"pyrH"	"UMPKI-CPLX"
"DNA polymerase III, &tau; subunit dimer"	"dnaX"	"CPLX0-3802"
"PF10636 family protein YdiE"	"ydiE"	"CPLX0-8185"
"ABC-type tripartite efflux pump"	"tolC" // "macB" // "macA"	"TRANS-200-CPLX"
"hydrogenase isozymes nickel incorporation protein HypB"	"hypB"	"CPLX0-3561"
"succinate:quinone oxidoreductase subcomplex"	"sdhD" // "sdhC" // "sdhB" // "sdhA"	"CPLX0-8160"
"superoxide dismutase (Fe)"	"sodB"	"SUPEROX-DISMUTFE-CPLX"
"pyridoxine 5'-phosphate synthase"	"pdxJ"	"CPLX0-321"
"succinyl-diaminopimelate desuccinylase"	"dapE"	"CPLX0-3161"
"ribulokinase"	"araB"	"RIBULOKIN-CPLX"
"FtsH/HflKC protease complex"	"hflC" // "hflK" // "ftsH"	"CPLX0-2982"
"CP4-57 prophage; RNase LS, toxin of the RnlAB toxin-antitoxin system"	"rnlA"	"CPLX0-8095"
